RD,MURDER,MANSLTR,FORCED_RAPE,ROBBERY,AGGRAV_ASSAULT,BURGLARY_RES,BURGLARY_COM,AUTO_BURG,GRAND_THEFT,PETTY_THEFT,BIKE_THEFT,AUTO_THEFT,ARSON,TOTAL_PART1,TOTAL_PART2,GRAND_TOTAL
010,0,0,0,0,0,0,0,0,1,0,0,0,0,1,0,1
020,0,0,0,0,0,0,1,2,0,1,0,1,0,5,5,10
021,0,0,0,0,0,0,0,4,1,0,0,0,0,5,0,5
030,0,0,0,0,0,0,0,0,0,0,0,0,0,0,0,0
031,0,0,0,0,0,0,0,0,0,0,0,0,0,0,0,0
041,0,0,0,0,0,0,0,0,0,0,0,0,0,0,1,1
042,0,0,0,0,0,0,0,0,0,0,0,0,0,0,1,1
043,0,0,0,0,0,0,1,0,0,0,0,0,0,1,1,2
044,0,0,0,0,0,0,0,0,0,0,0,0,0,0,1,1
045,0,0,0,0,2,0,0,0,0,0,0,0,0,2,2,4
051,0,0,0,0,0,0,0,0,0,1,0,0,0,1,1,2
052,0,0,0,1,0,0,0,0,0,0,0,1,0,2,5,7
053,0,0,0,0,0,0,0,0,1,0,0,0,0,1,0,1
061,0,0,0,0,0,0,0,1,0,0,0,0,0,1,3,4
062,0,0,0,1,1,1,0,1,0,0,0,0,0,4,4,8
063,0,0,0,0,0,0,0,0,0,0,0,0,0,0,1,1
064,0,0,0,1,0,1,0,0,0,0,0,0,0,2,2,4
071,0,0,0,0,0,0,1,0,0,1,0,0,0,2,0,2
072,0,0,0,0,0,1,0,0,1,2,0,2,0,6,2,8
073,0,0,0,0,0,1,0,2,0,1,0,0,0,4,12,16
074,0,0,0,0,0,0,0,0,0,0,0,0,0,0,3,3
075,0,0,0,0,0,0,0,0,0,0,0,0,0,0,2,2
076,0,0,0,0,0,1,0,0,0,2,0,0,0,3,5,8
081,0,0,0,0,2,0,0,0,0,4,2,0,1,9,8,17
082,0,0,0,3,0,1,2,2,1,1,1,2,0,13,8,21
083,0,0,0,0,0,0,0,0,0,0,1,2,0,3,2,5
084,0,0,0,0,0,0,0,1,0,1,0,0,0,2,0,2
085,0,0,0,0,0,0,0,0,1,0,0,0,0,1,0,1
091,0,0,0,0,0,2,2,0,0,6,0,2,0,12,3,15
092,0,0,0,0,0,1,0,0,0,1,0,0,0,2,2,4
093,0,0,0,0,1,1,0,0,0,1,0,0,0,3,3,6
094,1,0,0,0,0,1,0,0,0,0,0,0,0,2,14,16
101,0,0,0,0,0,1,0,1,0,1,0,1,0,4,1,5
103,0,0,0,0,0,2,0,1,0,1,0,0,1,5,2,7
104,0,0,0,0,0,0,0,1,0,1,0,1,0,3,4,7
111,0,0,0,1,1,0,0,0,0,2,1,0,0,5,9,14
112,0,0,0,1,0,0,0,0,0,4,0,1,0,6,6,12
113,0,0,0,0,0,0,1,0,0,0,0,0,0,1,5,6
114,0,0,0,0,0,0,0,0,0,0,0,1,0,1,1,2
121,0,0,0,3,0,2,0,0,0,0,0,0,0,5,2,7
122,0,0,0,1,0,0,0,1,0,1,0,2,0,5,7,12
123,0,0,0,0,0,0,0,0,0,0,1,1,0,2,3,5
124,0,0,0,0,0,0,0,0,0,0,0,1,0,1,2,3
131,0,0,0,0,0,0,0,0,0,3,0,0,0,3,3,6
132,0,0,0,0,0,3,0,1,0,1,0,1,0,6,2,8
133,0,0,0,0,0,1,0,0,0,0,0,1,0,2,5,7
134,0,0,0,1,8,1,0,0,0,0,0,0,0,10,2,12
141,0,0,0,0,0,1,1,2,0,0,0,2,0,6,1,7
142,0,0,0,0,0,0,0,0,0,0,0,0,0,0,4,4
143,0,0,0,0,0,0,0,1,0,2,0,0,0,3,4,7
144,0,0,0,0,0,1,0,0,0,0,0,1,0,2,0,2
151,0,0,0,0,0,1,0,1,1,0,1,0,2,6,3,9
152,0,0,0,0,1,1,0,0,3,3,0,2,0,10,5,15
153,0,0,0,0,0,0,1,1,3,0,2,1,0,8,9,17
161,0,0,0,2,4,1,1,1,0,3,3,1,1,17,12,29
162,0,0,0,0,2,0,0,0,1,0,1,0,1,5,2,7
163,0,0,0,0,0,0,1,0,1,3,0,0,0,5,5,10
164,0,0,0,1,1,1,2,0,2,5,1,3,0,16,19,35
171,0,0,0,0,0,0,0,0,1,1,0,1,0,3,12,15
172,0,0,0,3,0,2,0,2,1,1,0,0,0,9,2,11
173,0,0,0,0,0,1,1,1,1,1,2,1,0,8,7,15
174,0,0,0,2,1,1,0,0,0,2,0,0,0,6,6,12
181,0,0,0,1,2,0,0,0,2,1,0,1,1,8,7,15
182,0,0,0,0,0,0,0,0,0,0,0,0,0,0,3,3
183,0,0,0,2,1,0,0,0,0,1,1,1,0,6,3,9
184,0,0,0,0,0,2,0,1,0,0,0,2,0,5,8,13
191,0,0,0,0,0,1,0,1,0,1,0,0,0,3,0,3
192,0,0,0,0,2,1,0,0,0,0,0,1,0,4,5,9
193,0,0,0,3,2,0,0,0,0,0,0,0,0,5,6,11
201,0,0,0,1,0,0,1,0,0,4,0,1,0,7,3,10
202,0,0,0,0,0,1,1,0,1,1,0,0,0,4,3,7
203,0,0,0,0,0,0,0,0,0,2,0,1,0,3,3,6
204,0,0,0,0,1,0,2,0,0,1,1,2,0,7,1,8
211,0,0,0,0,0,0,0,2,1,0,0,0,0,3,3,6
212,0,0,0,0,0,0,0,2,1,2,2,0,0,7,3,10
213,0,0,0,0,0,2,0,1,1,1,0,0,0,5,1,6
214,0,0,0,0,0,0,0,0,1,2,0,1,0,4,5,9
215,0,0,0,0,0,0,0,0,0,0,0,0,0,0,0,0
216,0,0,0,1,0,2,0,0,0,0,0,0,0,3,2,5
221,0,0,0,2,1,5,0,1,0,0,2,1,0,12,3,15
222,0,0,0,0,0,0,0,1,1,0,0,1,0,3,3,6
223,0,0,0,0,1,1,1,1,0,2,1,0,0,7,4,11
224,0,0,0,0,0,3,0,2,2,2,0,-1,0,8,5,13
225,0,0,0,0,0,0,0,0,0,1,0,1,0,2,0,2
226,0,0,1,0,1,2,1,0,0,0,0,1,0,6,7,13
231,0,0,0,0,0,2,0,0,1,1,0,3,0,7,10,17
232,0,0,0,1,0,0,0,0,0,2,0,1,0,4,14,18
233,0,0,0,0,1,0,0,0,1,3,0,0,0,5,3,8
234,0,0,0,0,1,1,0,1,0,0,0,2,0,5,4,9
235,0,0,0,2,1,2,1,0,0,0,1,0,0,7,6,13
241,0,0,0,0,1,3,0,1,0,0,0,1,0,6,5,11
242,0,0,0,1,0,6,1,1,0,1,1,0,0,11,6,17
243,0,0,0,0,0,1,0,0,0,0,0,2,0,3,1,4
244,0,0,0,0,0,3,4,0,2,0,0,1,0,10,5,15
251,0,0,0,0,1,3,0,1,2,0,0,0,0,7,7,14
252,0,0,0,1,0,2,2,2,1,1,1,-1,0,9,5,14
253,0,0,0,0,0,0,0,0,0,1,1,1,0,3,5,8
271,0,0,0,0,0,1,0,0,0,1,0,0,0,2,7,9
272,0,0,1,0,0,3,0,0,1,0,1,0,0,6,4,10
273,0,0,1,0,1,0,0,1,0,4,0,0,0,7,3,10
274,0,0,0,0,0,0,0,0,1,0,0,1,1,3,4,7
281,0,0,0,2,3,2,0,1,3,0,0,0,0,11,7,18
282,0,0,0,1,1,0,0,1,0,0,1,0,0,4,13,17
291,1,0,0,0,0,0,0,0,1,2,0,1,0,5,3,8
292,0,0,0,1,0,1,0,2,0,1,0,1,0,6,7,13
294,0,0,0,1,1,1,0,1,0,0,0,0,0,4,4,8
301,0,0,0,0,1,1,1,0,1,1,0,1,0,6,5,11
302,0,0,0,0,1,0,0,0,0,1,0,0,0,2,4,6
303,0,0,1,0,1,0,0,0,0,1,0,1,0,4,3,7
304,0,0,0,1,1,0,0,1,0,0,0,0,0,3,0,3
311,0,0,0,0,0,0,0,1,0,0,0,0,0,1,0,1
312,0,0,0,1,1,0,0,0,0,0,1,-1,0,2,3,5
313,0,0,0,2,0,1,0,0,0,1,0,1,0,5,2,7
314,0,0,0,0,0,0,0,0,1,0,0,1,0,2,3,5
315,0,0,0,0,0,2,0,0,0,0,0,0,0,2,4,6
316,0,0,0,0,0,1,0,2,0,0,0,0,0,3,8,11
321,0,0,0,0,0,1,0,0,0,0,0,1,0,2,1,3
322,0,0,0,0,0,1,0,1,1,0,1,0,0,4,1,5
323,0,0,0,0,0,0,0,0,0,0,0,0,0,0,0,0
331,0,0,0,0,0,1,0,0,0,0,0,2,0,3,9,12
332,0,0,0,0,0,0,0,0,0,0,0,0,0,0,1,1
333,0,0,0,2,0,1,1,0,1,4,0,1,0,10,2,12
334,0,0,0,0,0,1,0,0,0,0,0,0,0,1,3,4
335,0,0,0,0,0,2,0,1,0,0,0,1,0,4,1,5
336,1,0,0,0,0,1,0,0,0,0,1,0,0,3,4,7
341,0,0,0,2,0,0,1,0,0,1,0,3,0,7,6,13
342,0,0,0,3,0,0,0,3,2,2,1,2,0,13,6,19
343,0,0,0,0,1,1,0,0,1,1,0,1,0,5,5,10
351,0,0,0,0,0,1,0,0,0,0,0,0,0,1,4,5
352,0,0,0,0,0,2,1,0,0,2,3,0,0,8,9,17
353,0,0,0,0,0,2,0,0,0,1,1,1,0,5,1,6
354,0,0,0,1,0,2,0,1,2,0,1,0,0,7,1,8
361,0,0,0,0,3,1,0,0,1,1,0,0,0,6,5,11
362,0,0,1,1,0,0,0,0,1,2,0,1,0,6,3,9
371,0,0,0,1,0,0,0,0,0,0,0,2,0,3,5,8
372,0,0,0,0,0,2,0,1,0,0,0,4,0,7,6,13
373,0,0,0,0,0,0,0,0,1,3,0,0,0,4,8,12
374,0,0,0,0,1,0,0,0,0,1,0,2,1,5,8,13
381,0,0,0,0,1,1,0,0,0,0,0,1,0,3,1,4
382,0,0,0,0,3,1,0,0,0,0,0,0,0,4,1,5
383,0,0,0,0,0,3,0,0,0,0,0,0,0,3,1,4
391,0,0,0,1,0,0,0,0,0,0,0,0,0,1,1,2
392,0,0,0,0,0,0,0,0,1,1,0,0,0,2,4,6
393,0,0,0,0,0,0,0,0,1,1,0,0,0,2,0,2
401,0,0,0,0,0,1,0,0,0,2,0,0,0,3,0,3
402,0,0,0,0,0,0,0,0,0,0,0,0,0,0,0,0
403,0,0,0,0,0,0,0,0,0,0,0,0,0,0,1,1
411,0,0,0,0,1,0,0,0,0,1,0,2,0,4,6,10
412,0,0,0,0,0,0,0,0,1,1,0,0,0,2,4,6
413,0,0,0,1,0,0,0,0,1,0,0,1,0,3,0,3
414,0,0,1,0,0,0,0,3,0,2,0,2,0,8,3,11
415,0,0,0,0,0,1,1,0,0,1,0,0,0,3,1,4
421,0,0,0,1,4,3,0,3,0,3,0,1,0,15,5,20
422,0,0,0,4,2,1,0,0,2,2,0,3,0,14,2,16
423,0,0,0,2,1,1,0,1,0,1,0,0,0,6,2,8
431,0,0,0,0,0,1,0,1,1,1,3,0,0,7,2,9
432,0,0,0,0,0,1,0,1,0,0,0,0,0,2,2,4
433,0,0,0,0,0,2,0,1,0,1,0,0,1,5,2,7
434,0,0,0,0,0,1,0,0,0,2,0,0,0,3,2,5
441,0,0,0,0,1,0,0,0,0,0,0,0,0,1,2,3
442,0,0,0,1,1,1,0,3,0,0,0,0,0,6,5,11
451,0,0,0,0,0,2,0,0,0,0,0,0,0,2,1,3
452,0,0,0,0,0,0,0,0,1,0,0,0,0,1,3,4
453,0,0,0,1,1,0,0,0,0,2,0,0,0,4,5,9
454,0,0,1,0,2,3,0,0,0,1,1,0,0,8,5,13
461,0,0,0,0,0,1,0,1,1,1,0,1,0,5,2,7
462,0,0,0,0,1,1,1,0,0,3,1,0,0,7,7,14
463,0,0,0,0,1,0,0,1,0,2,0,2,0,6,4,10
464,0,0,1,0,0,1,0,1,1,0,0,1,0,5,8,13
470,0,0,0,0,0,0,0,0,0,0,0,0,0,0,1,1
471,0,0,0,0,0,0,0,1,0,0,0,5,0,6,3,9
472,0,0,0,0,0,0,0,2,0,0,0,0,0,2,1,3
473,0,0,0,0,0,0,0,2,0,0,0,0,0,2,0,2
474,0,0,0,0,0,0,1,0,0,0,0,0,0,1,0,1
481,0,0,0,1,0,0,1,0,0,3,0,8,0,13,2,15
482,0,0,0,3,0,1,0,0,0,0,0,0,0,4,1,5
483,0,0,0,0,0,0,0,0,0,0,0,0,0,0,1,1
492,0,0,0,0,0,0,0,3,0,3,0,1,0,7,3,10
493,0,0,0,0,0,0,0,0,0,0,0,0,0,0,4,4
501,0,0,0,0,1,1,0,1,4,4,1,1,0,13,3,16
502,0,0,0,0,1,0,0,1,1,2,0,0,0,5,10,15
503,0,0,0,0,0,0,0,1,1,0,0,1,0,3,2,5
511,0,0,0,0,0,1,0,5,0,1,0,1,0,8,5,13
512,0,0,0,0,1,1,1,3,0,1,0,0,0,7,1,8
521,0,0,0,1,0,2,1,1,1,1,1,1,0,9,5,14
522,0,0,0,0,0,0,1,0,1,1,0,0,0,3,5,8
523,0,0,0,1,1,1,1,0,0,0,0,0,0,4,6,10
524,0,0,0,1,1,3,2,3,0,0,0,4,0,14,12,26
531,0,0,0,0,0,0,0,0,1,3,0,0,0,4,0,4
532,0,0,0,0,0,2,0,3,0,4,2,3,0,14,5,19
533,0,0,0,1,0,3,0,1,3,1,2,2,0,13,2,15
534,0,0,0,0,0,1,0,1,1,0,0,0,0,3,0,3
541,0,0,0,0,0,0,0,0,0,2,1,0,0,3,0,3
542,0,0,0,0,0,0,0,0,0,0,0,0,0,0,1,1
543,0,0,0,0,0,0,0,0,0,0,0,1,0,1,1,2
544,0,0,0,0,0,1,1,0,0,0,0,0,0,2,2,4
545,0,0,0,0,0,0,0,1,0,1,0,0,0,2,2,4
546,0,0,0,0,0,2,0,0,1,2,0,0,0,5,6,11
551,0,0,0,0,0,0,0,1,0,2,0,0,0,3,1,4
552,0,0,0,0,0,0,0,0,0,0,0,0,0,0,2,2
553,0,0,0,0,0,0,0,1,0,0,0,0,0,1,2,3
554,0,0,0,1,0,2,0,1,0,1,0,2,0,7,5,12
561,0,0,0,0,0,3,0,1,1,1,0,1,0,7,3,10
562,0,0,0,0,1,0,1,0,1,7,0,1,0,11,1,12
563,0,0,0,0,0,0,1,2,0,0,0,0,1,4,2,6
571,0,0,0,0,0,3,0,2,3,2,2,1,0,13,1,14
572,0,0,0,0,1,1,0,1,3,4,1,0,0,11,2,13
581,0,0,0,0,0,0,0,0,0,1,1,0,0,2,2,4
582,0,0,1,0,0,4,0,2,0,0,1,0,0,8,6,14
583,0,0,0,1,0,2,0,0,2,2,0,1,0,8,5,13
584,0,0,0,0,0,2,0,0,3,0,0,0,0,5,1,6
591,0,0,0,1,0,5,1,1,0,0,0,1,0,9,4,13
592,0,0,0,0,0,0,0,0,0,0,0,2,0,2,1,3
594,0,0,0,0,0,1,0,6,0,3,0,1,0,11,3,14
595,0,0,0,0,0,0,0,0,0,0,0,0,0,0,0,0
596,0,0,0,0,0,0,0,0,0,0,0,0,0,0,0,0
601,0,0,0,0,0,2,0,0,1,2,0,1,0,6,3,9
602,0,0,0,0,0,1,1,3,2,3,0,2,0,12,3,15
603,0,0,0,0,0,0,1,1,0,1,0,0,0,3,2,5
604,0,0,0,0,0,3,0,1,0,0,0,0,0,4,1,5
610,0,0,0,1,0,2,0,1,2,1,0,0,0,7,3,10
621,0,0,0,0,0,1,1,0,2,1,0,0,1,6,8,14
622,0,0,0,0,0,0,0,1,0,3,0,0,1,5,7,12
623,0,0,0,0,0,0,0,0,2,0,0,0,0,2,5,7
624,0,0,0,0,0,0,1,0,0,1,0,0,0,2,3,5
625,0,0,0,0,0,0,0,0,0,1,0,0,0,1,0,1
631,0,0,0,0,0,0,0,5,2,3,0,0,0,10,0,10
632,0,0,0,0,0,0,0,0,2,2,0,0,0,4,0,4
633,0,0,0,0,1,0,1,1,0,0,0,0,0,3,1,4
634,0,0,0,0,1,1,4,3,4,5,0,1,0,19,4,23
635,0,0,0,0,0,0,0,0,0,0,0,1,0,1,0,1
636,0,0,0,0,0,0,0,0,0,0,0,0,0,0,0,0
641,0,0,0,0,1,0,0,0,0,0,1,0,0,2,1,3
642,0,0,0,0,0,0,0,0,0,0,0,1,0,1,1,2
643,0,0,0,0,0,0,0,2,0,0,0,0,0,2,2,4
644,0,0,0,0,1,0,1,1,1,1,0,1,0,6,3,9
645,0,0,0,0,0,0,0,0,0,0,0,0,0,0,0,0
646,0,0,0,0,0,0,0,0,0,0,0,1,0,1,1,2
651,0,0,0,0,0,0,1,1,0,1,0,2,0,5,2,7
652,0,0,0,0,0,2,0,2,1,1,0,0,0,6,0,6
653,0,0,0,0,0,2,1,4,0,4,0,0,0,11,6,17
654,0,0,0,0,0,0,0,0,0,1,0,0,0,1,2,3
655,0,0,0,0,0,0,1,1,2,0,0,0,0,4,1,5
661,0,0,0,0,0,0,0,0,0,1,0,0,0,1,0,1
662,0,0,0,0,0,0,1,2,2,3,0,0,0,8,1,9
663,0,0,0,0,0,2,0,0,0,4,1,1,0,8,3,11
664,0,0,0,0,0,0,1,0,0,0,0,1,0,2,2,4
665,0,0,0,0,0,0,0,2,0,1,0,0,0,3,2,5
671,0,0,0,0,0,0,0,2,0,1,0,0,0,3,4,7
673,0,0,0,0,0,02,0,0,0,01,01,0,0,04,02,06
674,0,0,0,0,0,0,0,0,0,0,0,0,0,00,01,01
675,0,0,0,0,0,0,0,0,0,01,0,0,0,01,01,02
676,0,0,0,0,0,02,0,01,0,0,0,0,0,03,00,03
681,0,0,0,0,0,0,0,0,0,0,0,01,0,01,01,02
682,0,0,0,0,0,0,0,0,0,0,0,0,0,00,01,01
683,0,0,0,0,0,0,0,03,01,03,0,0,0,07,01,08
684,0,0,0,0,0,02,0,02,0,02,0,02,0,08,00,08
685,0,0,0,0,0,0,0,02,0,0,0,0,0,02,02,04
686,0,0,0,0,01,0,0,0,0,0,0,0,0,01,00,01
687,0,0,0,0,0,0,0,01,0,01,0,0,0,02,02,04
688,0,0,0,0,0,0,0,01,0,0,0,0,0,01,00,01
689,0,0,0,0,0,0,0,01,0,01,0,0,0,02,01,03
691,0,0,0,0,0,0,0,01,0,0,0,0,0,01,00,01
692,0,0,0,0,01,01,0,04,0,02,0,0,0,08,03,011
693,0,0,0,0,0,0,0,0,0,0,0,0,0,00,01,01
694,0,0,0,0,0,0,0,0,0,0,0,0,0,00,03,03
695,0,0,0,02,0,0,04,01,02,012,01,02,0,024,08,032
800,0,0,0,0,0,0,0,0,0,01,0,0,0,01,04,05
801,0,0,0,0,0,0,0,0,0,0,0,0,0,00,00,00
821,0,0,0,0,0,0,0,0,0,0,0,0,0,00,00,00
822,0,0,0,0,0,0,0,0,0,0,0,0,0,00,00,00
823,0,0,0,0,0,0,0,0,0,0,0,0,0,00,00,00
824,0,0,0,0,0,0,0,0,0,0,0,0,0,00,00,00
825,0,0,0,0,0,0,0,0,0,0,0,0,0,00,00,00
962,0,0,0,0,0,0,0,0,0,0,0,0,0,00,00,00
Unk,0,0,0,0,01,0,0,01,0,01,0,02,0,05,01,06
