RD,MURDER,MANSLTR,FORCED_RAPE,ROBBERY,AGGRAV_ASSAULT,BURGLARY_RES,BURGLARY_COM,AUTO_BURG,GRAND_THEFT,PETTY_THEFT,BIKE_THEFT,AUTO_THEFT,ARSON,TOTAL_PART1,TOTAL_PART2,GRAND_TOTAL
010,0,0,0,0,0,0,0,0,0,0,0,0,0,0,1,1
020,0,0,0,0,0,0,0,0,0,0,1,1,0,2,2,4
021,0,0,0,0,0,0,0,3,0,2,0,0,0,5,1,6
030,0,0,0,0,0,0,0,0,0,0,0,0,0,0,0,0
031,0,0,0,0,0,0,0,0,0,0,0,0,0,0,0,0
041,0,0,0,0,0,0,0,0,0,0,0,0,0,0,0,0
042,0,0,0,0,0,0,0,0,0,1,0,1,0,2,1,3
043,0,0,0,0,0,0,0,0,0,0,0,-1,0,-1,1,0
044,0,0,0,0,0,0,0,0,0,1,0,2,0,3,2,5
045,0,0,0,0,0,0,0,0,0,0,0,0,0,0,0,0
051,0,0,0,1,0,0,0,0,0,0,0,0,0,1,0,1
052,0,0,0,1,1,1,0,0,0,0,0,1,0,4,10,14
053,0,0,0,0,2,0,0,0,2,3,0,0,0,7,9,16
061,0,0,0,1,1,0,1,0,0,0,0,0,0,3,2,5
062,0,0,0,0,0,1,1,1,0,0,0,0,0,3,1,4
063,0,0,0,0,0,0,0,1,0,0,0,0,0,1,0,1
064,0,0,0,1,0,0,0,0,0,1,0,0,0,2,2,4
071,0,0,0,0,0,0,1,0,0,1,0,0,0,2,2,4
072,0,0,0,0,2,0,0,0,1,0,0,0,0,3,1,4
073,0,0,0,0,0,4,0,0,0,0,0,1,0,5,3,8
074,0,0,0,0,0,0,0,0,0,0,0,1,0,1,4,5
075,0,0,0,0,0,0,0,0,0,0,0,3,0,3,3,6
076,0,0,0,0,0,4,0,1,1,0,0,0,0,6,1,7
081,0,0,0,0,0,0,0,0,0,2,1,3,0,6,17,23
082,0,0,0,0,1,0,2,2,0,2,0,0,0,7,11,18
083,0,0,0,0,0,0,1,1,0,0,1,0,0,3,5,8
084,0,0,0,0,0,0,0,0,0,0,0,0,0,0,3,3
085,0,0,0,0,0,0,0,0,0,0,0,0,0,0,0,0
091,0,0,0,0,0,1,1,1,0,4,0,4,0,11,6,17
092,0,0,0,0,1,1,0,0,0,0,0,1,0,3,6,9
093,0,0,0,0,1,1,0,0,0,1,1,1,0,5,2,7
094,0,0,0,1,0,0,0,0,0,0,0,1,0,2,5,7
101,0,0,0,0,0,1,0,0,0,0,0,1,0,2,7,9
103,0,0,0,0,2,1,1,1,1,0,0,0,0,6,3,9
104,0,0,0,1,0,3,0,1,0,2,0,0,0,7,2,9
111,0,0,1,1,2,3,1,1,0,2,0,0,0,11,3,14
112,0,0,0,3,2,0,0,0,2,1,1,0,0,9,6,15
113,0,0,0,0,0,0,0,0,1,0,0,0,0,1,1,2
114,1,0,0,0,0,0,0,0,0,1,0,0,0,2,1,3
121,0,0,0,1,0,1,0,1,0,0,0,1,0,4,1,5
122,0,0,0,0,2,0,0,0,0,3,0,1,0,6,19,25
123,0,0,0,0,0,0,0,0,0,1,0,1,0,2,3,5
124,0,0,0,0,0,0,0,0,0,0,0,0,0,0,2,2
131,0,0,0,0,0,0,0,0,0,0,0,0,0,0,2,2
132,0,0,0,1,0,0,0,0,0,0,0,0,0,1,4,5
133,0,0,0,0,0,1,0,0,0,1,0,0,0,2,2,4
134,0,0,0,0,0,1,0,0,0,0,0,0,0,1,1,2
141,0,0,0,0,0,2,0,1,0,0,0,0,0,3,3,6
142,0,0,0,0,0,1,0,0,0,0,0,0,0,1,2,3
143,0,0,0,0,0,1,0,1,0,1,0,0,0,3,1,4
144,0,0,0,0,0,1,0,0,0,0,0,0,0,1,4,5
151,0,0,0,1,0,0,1,0,1,3,0,1,1,8,4,12
152,0,0,0,1,1,0,1,2,2,3,0,1,0,11,5,16
153,0,0,0,0,0,0,0,2,0,1,2,0,0,5,4,9
161,0,0,-1,0,1,2,0,2,0,3,1,0,0,8,10,18
162,0,0,0,1,0,2,0,1,1,2,0,0,0,7,4,11
163,0,0,0,0,0,0,0,0,0,3,0,1,0,4,4,8
164,0,0,0,2,0,0,5,0,1,12,0,0,0,20,5,25
171,0,0,0,1,1,0,0,0,0,1,0,0,0,3,5,8
172,0,0,0,0,0,2,0,1,0,1,0,1,0,5,2,7
173,0,0,0,1,0,0,0,0,1,4,0,1,0,7,4,11
174,0,0,0,1,0,1,0,1,0,3,0,0,0,6,2,8
181,0,0,0,0,1,1,0,0,0,1,0,0,0,3,3,6
182,0,0,0,0,0,0,0,0,0,0,0,0,0,0,3,3
183,0,0,0,0,0,1,1,0,1,1,0,1,0,5,5,10
184,0,0,0,0,1,0,0,0,0,1,0,0,0,2,11,13
191,0,0,0,1,0,0,1,1,1,6,0,0,0,10,3,13
192,0,0,0,1,0,0,1,1,0,1,0,0,0,4,4,8
193,0,0,0,3,3,0,0,0,0,1,0,0,0,7,9,16
201,0,0,0,1,0,0,1,0,0,2,0,0,0,4,3,7
202,0,0,0,0,0,0,0,0,0,0,0,0,0,0,7,7
203,0,0,0,1,0,2,0,0,0,1,0,0,0,4,6,10
204,0,0,1,1,0,0,0,0,0,0,0,0,0,2,0,2
211,0,0,0,0,0,1,0,1,0,0,0,1,0,3,0,3
212,0,0,0,0,1,0,0,0,1,0,0,0,0,2,4,6
213,0,0,0,1,0,0,0,0,0,0,0,0,0,1,1,2
214,0,0,1,1,0,0,3,0,0,15,0,0,0,20,3,23
215,0,0,0,0,0,0,0,1,0,0,0,1,0,2,1,3
216,0,0,0,0,0,0,0,3,0,1,0,1,0,5,3,8
221,0,0,0,0,0,3,1,0,0,2,0,2,0,8,8,16
222,0,0,0,0,0,1,2,0,0,1,1,1,0,6,0,6
223,0,0,0,0,1,0,0,0,0,3,0,0,0,4,3,7
224,0,0,0,0,0,3,0,2,0,4,0,3,0,12,5,17
225,0,0,0,0,0,2,0,1,1,2,0,1,0,7,0,7
226,0,0,0,0,0,7,0,0,0,1,0,1,0,9,3,12
231,0,0,0,1,1,2,0,1,0,0,2,2,0,9,3,12
232,0,0,0,2,0,2,0,0,0,0,0,0,0,4,4,8
233,0,0,1,1,1,8,3,1,0,4,0,0,0,19,4,23
234,0,0,0,1,2,4,0,0,1,0,0,1,0,9,8,17
235,0,0,0,2,3,7,1,0,0,1,0,4,2,20,11,31
241,0,0,0,0,0,0,0,2,0,0,0,2,0,4,5,9
242,0,0,1,0,1,0,0,1,0,2,0,3,1,9,6,15
243,0,0,0,0,0,1,0,0,0,1,0,0,0,2,3,5
244,0,0,1,0,0,2,3,1,0,1,0,0,0,8,8,16
251,0,0,0,1,2,3,0,1,1,0,0,1,0,9,6,15
252,0,0,0,1,1,0,0,1,0,0,0,2,0,5,3,8
253,0,0,0,1,0,1,1,0,1,0,0,2,0,6,2,8
271,0,0,0,1,0,2,0,0,1,1,1,0,0,6,10,16
272,0,0,0,2,1,2,0,0,0,2,0,2,0,9,3,12
273,0,0,0,1,0,1,0,0,0,0,0,1,2,5,8,13
274,0,0,0,0,0,1,0,1,0,0,0,0,0,2,2,4
281,0,0,-1,0,2,1,0,1,1,1,1,2,0,8,9,17
282,0,0,0,0,1,3,0,2,0,1,1,1,0,9,10,19
291,0,0,0,1,0,0,0,0,0,1,0,0,0,2,3,5
292,0,0,0,0,2,0,0,0,0,3,0,1,0,6,6,12
294,0,0,0,0,0,2,0,1,1,1,0,1,0,6,7,13
301,0,0,1,0,1,0,0,0,0,1,0,0,0,3,1,4
302,1,0,0,1,1,0,0,0,0,0,0,0,0,3,1,4
303,0,0,0,0,1,0,0,0,0,2,0,0,0,3,5,8
304,0,0,0,1,0,0,0,0,0,1,0,0,0,2,7,9
311,0,0,0,0,0,1,0,1,0,0,0,2,0,4,0,4
312,0,0,0,1,0,1,0,0,0,0,0,0,0,2,1,3
313,0,0,0,1,0,0,0,0,1,1,0,0,0,3,2,5
314,0,0,0,0,0,0,0,0,0,1,0,2,0,3,4,7
315,0,0,0,0,0,1,0,0,0,0,0,0,0,1,1,2
316,0,0,0,0,0,0,0,0,0,3,0,0,0,3,5,8
321,0,0,0,0,0,1,1,0,0,0,0,0,0,2,1,3
322,0,0,0,0,0,1,1,0,0,2,0,0,0,4,1,5
323,0,0,0,0,0,0,0,0,0,0,0,0,0,0,0,0
331,0,0,0,0,2,0,0,4,0,0,0,1,0,7,6,13
332,0,0,0,0,0,1,0,0,0,0,0,0,0,1,1,2
333,0,0,0,2,0,1,0,0,0,2,0,1,0,6,7,13
334,0,0,0,0,0,1,0,1,1,1,0,1,0,5,1,6
335,0,0,0,0,0,0,0,0,0,0,0,0,0,0,1,1
336,0,0,0,1,0,1,0,0,0,0,0,0,0,2,2,4
341,0,0,0,0,1,6,0,0,1,0,0,11,2,21,5,26
342,0,0,0,1,5,3,0,0,0,2,1,4,0,16,14,30
343,0,0,0,0,0,1,0,4,0,0,1,3,0,9,6,15
351,0,0,0,0,3,0,0,0,0,1,0,1,0,5,8,13
352,0,0,0,0,2,1,0,1,0,6,0,2,0,12,1,13
353,0,0,0,1,0,2,0,0,1,2,0,1,0,7,4,11
354,0,0,0,0,0,1,0,1,0,0,0,3,0,5,4,9
361,0,0,0,0,1,1,2,0,1,0,1,0,0,6,3,9
362,0,0,0,0,0,1,0,3,0,1,0,2,0,7,2,9
371,0,0,0,1,1,1,0,0,0,2,0,0,0,5,3,8
372,0,0,0,0,0,1,0,2,0,0,0,0,0,3,5,8
373,0,0,0,0,1,0,0,2,0,1,0,0,0,4,2,6
374,0,0,0,1,0,0,0,0,0,1,0,2,0,4,3,7
381,0,0,0,0,0,0,0,0,0,1,0,1,0,2,4,6
382,0,0,0,0,0,0,0,3,0,0,0,1,0,4,5,9
383,0,0,0,0,0,0,0,0,0,0,0,3,0,3,4,7
391,0,0,0,0,0,0,0,0,0,0,0,0,0,0,0,0
392,0,0,0,0,1,0,0,0,0,0,1,0,0,2,3,5
393,0,0,0,0,0,0,0,0,0,0,0,0,0,0,0,0
401,0,0,0,0,0,1,0,0,0,0,0,0,0,1,1,2
402,0,0,0,0,0,0,0,0,0,0,0,0,0,0,0,0
403,0,0,0,0,0,0,0,0,1,0,0,0,0,1,0,1
411,0,0,0,1,0,4,0,2,0,2,0,0,0,9,4,13
412,0,0,0,2,0,1,0,0,0,2,0,0,0,5,1,6
413,0,0,0,0,0,4,0,0,0,0,0,1,0,5,5,10
414,0,0,0,1,0,3,2,1,1,0,0,0,0,8,2,10
415,0,0,1,0,0,2,0,1,0,0,0,2,0,6,2,8
421,0,0,0,0,3,3,1,0,0,1,0,1,1,10,3,13
422,0,0,0,0,0,5,0,0,0,3,0,3,0,11,2,13
423,0,0,0,0,0,0,0,2,0,3,0,7,0,12,6,18
431,0,0,0,0,1,0,1,0,0,2,0,0,0,4,0,4
432,0,0,0,0,0,0,0,0,0,1,0,0,0,1,0,1
433,0,0,0,0,0,0,0,0,1,3,2,0,0,6,3,9
434,0,0,0,0,0,3,0,2,0,3,0,0,0,8,6,14
441,0,0,0,0,0,0,0,0,0,0,0,1,0,1,0,1
442,0,0,0,0,0,2,0,1,1,2,0,1,0,7,3,10
451,0,0,0,0,1,3,0,1,0,0,1,1,0,7,0,7
452,0,0,0,1,1,2,0,0,0,2,0,1,0,7,4,11
453,0,0,0,0,0,0,0,1,0,0,1,0,0,2,3,5
454,0,0,1,0,1,1,0,2,0,1,0,2,0,8,1,9
461,0,0,0,0,2,2,0,1,0,0,0,1,0,6,5,11
462,0,0,0,1,1,0,1,1,0,0,0,2,0,6,7,13
463,0,0,0,0,1,0,1,3,0,1,1,0,0,7,7,14
464,0,0,1,1,0,1,0,1,0,0,0,0,0,4,1,5
470,0,0,0,0,0,0,0,0,0,0,0,2,0,2,2,4
471,0,0,0,0,0,0,1,0,0,0,0,2,0,3,3,6
472,0,0,0,0,0,0,0,0,0,0,0,0,0,0,0,0
473,0,0,0,0,0,0,0,0,0,0,0,0,0,0,0,0
474,0,0,0,0,0,0,0,0,0,0,0,0,0,0,0,0
481,0,0,0,0,0,0,1,3,0,1,0,1,1,7,3,10
482,0,0,0,1,0,4,0,0,0,0,0,0,0,5,3,8
483,0,0,0,0,0,0,0,0,0,1,0,1,0,2,2,4
492,0,0,0,0,1,2,0,0,1,2,1,0,0,7,1,8
493,0,0,0,0,0,3,0,0,0,0,0,1,0,4,0,4
501,0,0,0,0,0,1,1,1,1,6,0,0,0,10,6,16
502,0,0,0,1,1,2,0,8,1,0,0,0,0,13,6,19
503,0,0,0,1,0,1,1,0,1,2,0,0,0,6,4,10
511,0,0,0,0,2,4,0,2,1,1,1,1,0,12,6,18
512,0,0,0,2,0,0,0,1,0,3,0,3,0,9,6,15
521,0,0,0,1,4,1,1,1,0,0,0,0,0,8,9,17
522,0,0,0,2,1,2,0,0,1,1,0,3,0,10,2,12
523,0,0,0,0,0,1,0,1,0,2,0,0,0,4,4,8
524,0,0,0,1,0,1,2,2,0,2,0,1,1,10,12,22
531,0,0,0,0,0,0,0,0,0,2,0,1,0,3,1,4
532,0,0,0,0,0,4,1,0,1,7,0,2,0,15,7,22
533,0,0,0,0,0,3,0,0,0,2,2,0,0,7,2,9
534,0,0,0,0,1,1,0,0,0,1,0,0,0,3,2,5
541,0,0,0,1,0,2,0,1,0,2,1,3,0,10,0,10
542,0,0,0,0,0,2,0,0,0,0,3,0,0,5,2,7
543,0,0,0,0,1,0,0,1,0,2,0,0,1,5,2,7
544,0,0,0,0,0,2,0,0,1,0,0,2,0,5,0,5
545,0,0,0,1,2,3,0,1,0,2,0,0,0,9,2,11
546,0,0,0,0,0,4,0,1,0,1,1,1,0,8,3,11
551,0,0,-1,0,0,4,1,0,1,0,0,1,0,6,3,9
552,0,0,0,0,0,1,0,0,0,1,0,1,0,3,4,7
553,0,0,0,0,0,0,0,0,1,1,0,2,0,4,0,4
554,0,0,0,0,0,1,0,2,1,0,0,3,0,7,3,10
561,0,0,0,0,0,0,0,1,0,1,1,1,0,4,3,7
562,0,0,0,0,0,3,0,0,1,4,0,2,0,10,4,14
563,0,0,0,0,1,0,0,0,1,0,0,0,0,2,0,2
571,0,0,0,0,0,1,0,1,0,0,0,1,0,3,4,7
572,0,0,0,0,0,2,0,4,0,0,3,1,0,10,6,16
581,0,0,0,0,0,0,0,2,1,0,0,0,0,3,0,3
582,0,0,0,0,0,1,0,2,2,1,0,0,0,6,2,8
583,0,0,0,0,0,1,0,1,1,0,1,1,0,5,4,9
584,0,0,0,0,0,1,0,1,0,2,0,0,0,4,1,5
591,0,0,0,0,0,2,0,2,0,1,0,0,0,5,0,5
592,0,0,0,0,0,0,0,0,0,0,0,0,0,0,0,0
594,0,0,0,0,0,4,0,1,0,2,0,1,0,8,4,12
595,0,0,0,0,0,0,2,0,0,0,0,0,0,2,0,2
596,0,0,0,0,0,0,0,0,0,0,0,0,0,0,0,0
601,0,0,0,0,1,1,0,1,0,0,0,3,0,6,1,7
602,0,0,0,0,0,0,0,4,1,1,0,3,0,9,7,16
603,0,0,0,0,1,1,1,0,1,0,0,0,0,4,10,14
604,0,0,0,0,0,1,0,0,0,2,0,2,0,5,0,5
610,0,0,0,0,0,0,0,0,0,1,0,0,0,1,1,2
621,0,0,0,0,0,0,1,1,0,4,0,0,0,6,3,9
622,0,0,0,0,0,2,0,0,2,3,0,0,0,7,3,10
623,0,0,0,0,0,0,0,0,0,4,0,0,0,4,4,8
624,0,0,0,0,0,0,0,0,0,0,0,1,0,1,0,1
625,0,0,0,0,0,0,0,0,0,0,0,0,0,0,1,1
631,0,0,0,0,0,0,1,0,0,5,0,1,0,7,3,10
632,0,0,0,0,0,0,0,0,0,0,0,0,0,0,1,1
633,0,0,0,0,0,0,0,0,0,0,0,0,0,0,0,0
634,0,0,0,0,0,1,2,0,0,6,0,1,0,10,1,11
635,0,0,0,0,0,0,0,0,0,0,0,0,0,0,0,0
636,0,0,0,0,0,0,0,0,0,0,0,0,0,0,0,0
641,0,0,0,0,0,0,0,0,0,0,0,0,0,0,1,1
642,0,0,0,0,0,2,0,0,0,0,0,0,0,2,0,2
643,0,0,0,0,1,1,0,2,0,0,0,0,0,4,0,4
644,0,0,0,0,2,1,0,1,0,0,0,0,0,4,5,9
645,0,0,0,0,0,0,0,0,0,0,0,0,0,0,1,1
646,0,0,0,0,0,0,0,0,0,1,0,1,0,2,1,3
651,0,0,1,0,0,0,0,0,1,3,0,0,0,5,3,8
652,0,0,0,0,0,0,0,2,0,1,0,0,0,3,0,3
653,0,0,0,1,0,1,1,0,1,1,0,0,0,5,1,6
654,0,0,0,0,0,0,2,4,2,3,0,1,0,12,1,13
655,0,0,0,0,1,0,0,1,0,0,0,0,0,2,2,4
661,0,0,0,0,0,0,0,0,0,0,0,0,0,0,4,4
662,0,0,0,0,0,0,0,0,0,4,0,1,0,5,3,8
663,0,0,0,0,0,1,3,4,2,4,0,1,0,15,0,15
664,0,0,0,0,0,0,1,0,0,1,0,1,0,3,3,6
665,0,0,0,0,0,0,0,0,0,6,0,3,0,9,0,9
671,0,0,0,0,0,1,0,0,0,1,0,0,0,2,1,3
673,0,0,0,0,0,03,0,0,01,0,0,0,0,04,01,05
674,0,0,0,01,0,02,01,0,0,01,0,0,0,05,05,010
675,0,0,0,0,01,0,0,0,0,01,0,01,0,03,03,06
676,0,0,0,0,0,0,0,0,02,02,0,0,0,04,01,05
681,0,0,0,0,0,0,0,0,0,01,0,0,0,01,01,02
682,0,0,0,0,0,0,0,0,01,0,0,0,0,01,00,01
683,0,0,0,0,0,01,0,01,0,01,0,0,0,03,02,05
684,0,0,0,0,0,0,0,01,0,0,0,0,0,01,01,02
685,0,0,0,0,0,0,0,0,0,01,0,0,0,01,05,06
686,0,0,0,0,0,0,0,01,0,0,0,0,0,01,01,02
687,0,0,0,0,0,0,0,0,01,0,0,0,0,01,01,02
688,0,0,0,0,0,0,0,0,0,0,0,0,0,00,00,00
689,0,0,0,0,0,01,0,0,0,01,0,0,0,02,02,04
691,0,0,0,0,0,0,0,0,0,0,0,0,0,00,00,00
692,0,0,0,0,0,0,0,04,0,02,0,03,0,09,03,012
693,0,0,0,0,0,0,0,0,0,0,0,0,0,00,00,00
694,0,0,0,0,0,0,0,0,0,0,0,0,0,00,00,00
695,0,0,0,0,0,0,03,03,02,02,0,01,0,011,02,013
800,0,0,0,0,01,0,0,0,0,-1,0,0,0,00,06,06
801,0,0,0,0,0,0,0,0,0,0,0,0,0,00,00,00
821,0,0,0,0,0,0,0,0,0,0,0,0,0,00,00,00
822,0,0,0,0,0,0,0,0,0,0,0,0,0,00,00,00
823,0,0,0,0,0,0,0,0,0,0,0,0,0,00,00,00
824,0,0,0,0,0,0,0,0,0,0,0,0,0,00,00,00
825,0,0,0,0,0,0,0,0,0,0,0,0,0,00,00,00
962,0,0,0,0,0,0,0,0,0,0,0,0,0,00,00,00
Unk,0,0,01,0,0,0,01,02,01,01,0,01,01,08,04,012
