RD,MURDER,MANSLTR,FORCED_RAPE,ROBBERY,AGGRAV_ASSAULT,BURGLARY_RES,BURGLARY_COM,AUTO_BURG,GRAND_THEFT,PETTY_THEFT,BIKE_THEFT,AUTO_THEFT,ARSON,TOTAL_PART1,TOTAL_PART2,GRAND_TOTAL
010,0,0,0,0,0,0,0,0,0,0,0,0,0,0,0,0
020,0,0,0,0,0,0,0,0,0,3,0,0,0,3,5,8
021,0,0,0,0,0,0,0,1,0,1,0,0,0,2,2,4
030,0,0,0,0,0,0,0,0,0,0,0,0,0,0,1,1
031,0,0,0,0,0,0,0,0,0,0,0,0,0,0,0,0
041,0,0,0,1,0,0,0,0,0,0,0,0,0,1,1,2
042,0,0,0,0,1,0,0,0,0,1,0,0,0,2,0,2
043,0,0,0,0,0,0,0,0,0,1,0,0,0,1,0,1
044,0,0,0,0,0,0,0,1,0,0,0,0,0,1,0,1
051,0,0,0,1,0,0,0,1,1,1,0,1,0,5,4,9
052,0,0,0,2,0,0,0,1,0,2,0,2,0,7,8,15
053,0,0,0,0,1,0,0,0,0,0,0,0,0,1,10,11
061,0,0,0,1,0,0,0,0,0,0,0,0,0,1,3,4
062,0,0,0,0,0,1,0,1,0,1,0,2,0,5,2,7
063,0,0,0,0,0,1,0,0,0,0,0,1,0,2,0,2
064,0,0,0,0,1,0,0,0,0,0,0,0,0,1,2,3
071,0,0,0,1,1,0,1,0,0,0,0,3,0,6,4,10
072,0,0,0,0,0,2,0,4,0,0,1,1,0,8,1,9
073,0,0,0,0,0,0,1,0,0,0,0,0,0,1,2,3
074,0,0,0,0,0,0,1,0,0,1,0,1,0,3,2,5
075,0,0,0,0,0,0,0,0,1,0,0,1,0,2,3,5
076,0,0,1,0,0,3,1,0,0,1,0,1,0,7,3,10
081,0,0,0,0,0,0,0,0,0,3,1,0,0,4,10,14
082,0,0,0,0,0,0,1,0,1,4,2,2,0,10,8,18
083,0,0,0,0,0,0,0,0,1,0,0,0,0,1,1,2
084,0,0,0,0,0,0,1,0,0,0,0,0,0,1,1,2
085,0,0,0,0,0,0,0,1,0,0,0,1,0,2,1,3
091,0,0,0,2,3,2,1,3,1,2,3,1,1,19,6,25
092,0,0,0,0,0,0,0,0,1,2,0,0,0,3,4,7
093,0,0,0,0,1,0,0,0,0,0,0,2,0,3,0,3
094,0,0,0,0,0,3,0,0,0,0,0,0,0,3,3,6
101,0,0,0,2,0,0,0,1,0,2,0,1,0,6,7,13
102,0,0,0,0,1,3,0,1,0,0,2,1,0,8,4,12
104,0,0,0,0,0,0,0,1,0,1,0,0,0,2,3,5
111,0,0,0,0,0,2,0,4,1,1,0,6,0,14,11,25
112,0,0,0,3,3,0,0,0,0,1,0,2,1,10,10,20
113,0,0,0,0,0,1,2,1,0,1,0,1,0,6,1,7
114,0,0,0,1,0,0,0,0,0,0,1,0,0,2,4,6
121,0,0,0,0,0,0,1,1,0,1,0,1,0,4,6,10
122,0,0,0,1,1,2,0,1,0,1,2,3,0,11,11,22
123,0,0,0,0,0,2,0,0,0,2,0,0,0,4,4,8
124,0,0,0,0,0,2,0,0,0,1,0,1,0,4,0,4
131,0,0,0,2,0,0,0,2,0,1,0,0,0,5,4,9
132,0,0,0,0,0,0,0,0,0,1,0,0,0,1,0,1
133,0,0,0,0,0,2,0,0,0,0,0,1,0,3,2,5
134,0,0,0,0,0,3,1,0,0,1,0,1,0,6,2,8
141,0,0,0,1,0,0,0,2,2,1,0,3,0,9,0,9
142,0,0,0,0,1,0,0,2,0,1,1,0,0,5,3,8
143,0,0,0,0,0,3,0,1,0,1,0,0,0,5,1,6
144,0,0,0,0,0,2,0,2,0,0,0,1,0,5,1,6
151,0,0,0,1,1,0,0,0,1,1,2,1,0,7,6,13
152,0,0,0,1,1,2,1,1,6,2,1,1,0,16,2,18
153,0,0,0,0,1,0,0,2,0,3,0,0,0,6,10,16
161,0,0,0,0,0,1,4,0,1,4,3,2,0,15,10,25
162,0,0,0,0,1,0,0,0,0,0,2,1,0,4,1,5
163,0,0,0,0,1,0,1,0,2,3,2,0,0,9,6,15
164,0,0,0,2,0,2,8,1,2,13,2,2,0,32,7,39
171,0,0,0,2,1,0,0,1,1,0,1,0,0,6,3,9
172,0,0,0,2,0,2,0,0,0,1,0,1,0,6,5,11
173,0,0,0,0,0,3,0,0,0,1,1,1,0,6,10,16
174,0,0,0,1,0,0,1,1,1,6,0,5,0,15,4,19
181,0,0,0,0,4,0,0,2,0,0,1,1,0,8,3,11
182,0,0,0,0,4,1,0,0,0,1,0,2,0,8,2,10
183,0,0,0,0,0,1,0,2,0,0,0,2,0,5,5,10
184,0,0,0,1,2,2,1,3,0,1,1,4,0,15,11,26
191,0,0,0,1,0,0,0,1,0,1,0,1,0,4,4,8
192,0,0,0,0,1,0,0,1,0,0,0,1,0,3,4,7
193,0,0,2,1,0,0,0,0,0,0,0,3,0,6,3,9
194,0,0,0,2,0,0,1,0,0,4,0,1,0,8,2,10
202,0,0,0,0,0,0,0,0,0,0,0,0,0,0,0,0
203,0,0,0,0,0,1,1,0,0,2,0,2,0,6,3,9
204,0,0,0,1,0,2,0,1,1,0,0,0,0,5,4,9
211,0,0,0,1,0,0,1,3,0,1,0,1,0,7,1,8
212,0,0,0,0,0,0,0,1,0,0,0,0,0,1,1,2
213,0,0,0,0,0,0,0,0,0,0,0,0,0,0,1,1
214,0,0,0,1,0,0,5,0,0,0,0,0,0,6,3,9
215,0,0,0,0,0,1,0,0,0,0,0,0,0,1,2,3
216,0,0,1,0,0,1,0,2,0,0,0,0,0,4,3,7
221,0,0,0,2,0,4,0,0,0,3,0,0,0,9,5,14
222,0,0,0,0,0,1,2,1,0,1,0,1,0,6,1,7
223,0,0,0,0,0,1,1,2,0,1,0,0,0,5,0,5
224,0,0,0,0,0,0,0,3,1,1,0,3,0,8,2,10
225,0,0,0,0,0,0,0,0,0,0,0,0,0,0,0,0
226,0,0,0,1,0,4,0,0,0,2,0,0,0,7,1,8
231,0,0,0,1,2,2,1,0,0,0,0,1,0,7,3,10
232,0,0,0,1,0,1,0,1,0,1,0,2,0,6,1,7
233,0,0,0,0,0,5,1,1,0,1,0,0,0,8,6,14
234,0,0,0,1,0,1,1,0,0,2,0,1,0,6,6,12
235,0,0,0,1,0,2,0,2,0,2,0,1,0,8,9,17
241,0,0,0,1,1,0,0,1,2,0,0,3,0,8,3,11
242,0,0,0,1,1,2,0,2,0,1,0,1,0,8,5,13
243,0,0,0,3,0,1,0,1,0,2,0,1,0,8,1,9
244,0,0,0,1,4,4,0,2,0,5,0,1,0,17,4,21
251,0,0,1,1,2,0,0,1,0,1,0,0,0,6,4,10
252,1,0,0,1,1,0,0,1,0,0,1,1,0,6,6,12
253,0,0,0,0,0,0,0,0,0,1,0,3,0,4,2,6
271,0,0,0,2,0,0,0,3,0,0,0,1,0,6,3,9
272,0,0,0,3,0,7,0,3,1,1,0,2,0,17,7,24
273,0,0,0,0,0,0,0,1,0,2,2,2,0,7,2,9
274,0,0,0,0,0,4,0,2,0,0,0,0,0,6,2,8
281,0,0,0,0,1,0,0,0,1,0,0,0,0,2,4,6
282,0,0,0,1,1,1,0,1,0,1,1,0,0,6,6,12
291,0,0,0,0,0,0,0,0,0,1,0,0,0,1,1,2
292,0,0,1,3,1,0,0,0,0,1,0,0,0,6,9,15
293,0,0,0,0,0,1,0,0,0,0,0,1,0,2,8,10
301,0,0,0,2,1,0,0,0,0,0,0,1,0,4,4,8
302,0,0,0,1,2,1,1,1,0,1,1,1,0,9,2,11
303,0,0,0,1,0,0,1,0,0,0,0,0,0,2,12,14
304,0,0,0,2,0,0,0,0,0,1,0,0,0,3,2,5
311,0,0,0,0,0,1,0,0,0,0,0,0,0,1,0,1
312,0,0,0,0,0,0,0,0,0,2,0,0,0,2,2,4
313,0,0,1,0,0,0,0,0,1,2,0,0,0,4,3,7
314,0,0,0,1,3,1,0,0,0,0,0,2,0,7,6,13
315,0,0,0,0,1,1,0,1,0,1,0,0,0,4,5,9
316,0,0,0,1,3,1,0,0,0,0,0,1,0,6,1,7
321,0,0,0,0,0,1,0,0,0,1,0,0,0,2,3,5
322,0,0,0,0,0,1,0,0,0,0,0,0,0,1,1,2
323,0,0,0,0,0,0,0,0,0,0,0,0,0,0,0,0
331,0,0,0,0,0,2,1,0,1,1,0,1,0,6,5,11
332,0,0,0,0,0,0,1,0,0,1,0,0,0,2,1,3
333,0,0,0,0,0,2,1,0,3,6,0,0,0,12,4,16
334,0,0,0,0,0,1,0,0,0,3,0,2,0,6,1,7
335,0,0,0,0,0,0,0,0,0,0,0,0,0,0,2,2
336,0,0,0,0,0,0,1,1,0,2,0,0,0,4,7,11
341,0,0,0,1,0,1,0,2,0,1,0,3,0,8,9,17
342,0,0,0,2,1,0,0,5,1,1,0,4,0,14,5,19
343,0,0,0,2,0,4,0,1,0,0,0,2,0,9,10,19
351,0,0,0,1,1,2,1,1,1,2,3,3,0,15,11,26
352,0,0,0,1,1,1,1,1,0,2,0,3,0,10,5,15
353,0,0,0,0,0,1,0,0,1,0,1,3,0,6,2,8
354,0,0,0,0,1,0,0,1,0,0,1,0,0,3,6,9
361,0,0,0,0,2,1,0,1,3,1,0,0,0,8,9,17
362,0,0,0,0,1,1,0,0,0,1,0,0,0,3,7,10
371,0,0,0,2,0,2,0,0,0,1,0,1,1,7,5,12
372,0,0,0,0,3,1,0,0,0,1,0,2,0,7,9,16
373,0,0,0,0,1,1,0,0,0,1,1,3,0,7,3,10
374,0,0,0,0,2,1,0,2,1,0,1,2,0,9,7,16
381,0,0,0,0,0,1,0,1,2,2,0,3,0,9,5,14
382,0,0,0,1,1,0,0,1,0,2,1,3,0,9,1,10
383,0,0,0,0,0,0,0,1,0,0,0,0,0,1,2,3
384,0,0,0,3,4,1,0,0,0,0,0,1,0,9,1,10
392,0,0,0,1,1,1,0,0,0,1,1,0,0,5,2,7
393,0,0,0,0,0,0,0,0,0,0,0,0,0,0,0,0
401,0,0,0,0,0,1,0,1,0,2,0,0,0,4,2,6
402,0,0,0,0,0,1,0,0,0,1,0,0,0,2,0,2
403,0,0,0,0,0,0,0,0,0,1,0,0,0,1,0,1
411,0,0,0,1,0,0,0,0,0,1,0,0,0,2,5,7
412,0,0,0,0,3,0,0,0,0,1,0,0,0,4,0,4
413,0,0,0,1,0,0,0,1,0,6,0,0,0,8,4,12
414,0,0,0,1,1,0,0,1,0,1,0,2,0,6,3,9
415,0,0,0,0,0,0,0,3,0,3,0,1,0,7,1,8
421,0,0,0,0,0,0,0,0,0,1,1,2,0,4,3,7
422,0,0,0,1,9,1,0,2,0,1,1,2,0,17,8,25
423,0,0,0,1,2,4,1,0,0,3,0,1,0,12,7,19
431,0,0,0,0,0,1,0,0,0,0,0,0,0,1,1,2
432,0,0,0,0,1,1,0,0,0,2,0,0,0,4,5,9
433,0,0,0,0,0,3,0,0,0,1,2,1,0,7,6,13
434,0,0,0,0,0,2,0,0,0,0,4,1,0,7,0,7
441,0,0,0,0,0,2,0,1,0,0,1,1,0,5,0,5
442,0,0,0,0,0,0,0,0,0,0,0,1,0,1,2,3
451,0,0,0,0,2,1,0,1,0,2,0,0,0,6,11,17
452,0,0,0,1,1,2,0,1,0,0,0,0,0,5,0,5
453,0,0,0,0,0,1,0,0,0,1,1,0,0,3,3,6
454,0,0,0,1,1,1,1,0,0,0,0,1,0,5,9,14
461,0,0,0,1,0,0,0,0,0,0,0,1,0,2,3,5
462,0,0,0,1,0,0,0,1,0,1,0,1,0,4,5,9
463,0,0,0,1,1,0,0,2,0,0,0,0,0,4,5,9
464,0,0,0,0,1,1,0,1,0,1,1,2,0,7,10,17
470,0,0,0,1,0,0,0,0,0,0,0,1,0,2,0,2
471,0,0,0,0,0,0,0,0,0,1,0,19,0,20,2,22
472,0,0,0,0,0,0,0,0,0,0,0,0,0,0,0,0
473,0,0,0,0,0,0,0,0,1,0,0,0,0,1,0,1
474,0,0,0,0,0,0,0,0,0,0,0,0,0,0,0,0
481,0,0,0,0,0,0,2,0,0,2,0,4,0,8,3,11
482,0,0,0,0,1,0,0,0,0,0,0,0,0,1,2,3
483,0,0,0,0,0,0,0,0,0,0,1,0,0,1,1,2
491,0,0,0,0,1,1,0,0,0,0,2,0,0,4,1,5
493,0,0,0,0,0,0,0,1,0,0,0,0,0,1,3,4
501,0,0,0,0,0,5,3,1,0,4,2,0,0,15,11,26
502,0,0,0,0,1,2,0,0,0,2,0,0,0,5,1,6
503,0,0,0,0,0,1,0,1,1,1,2,1,0,7,4,11
511,0,0,0,0,1,1,0,1,0,1,0,0,0,4,5,9
512,0,0,0,0,2,0,0,0,0,2,0,0,0,4,8,12
521,0,0,0,1,0,1,0,1,0,2,0,4,0,9,5,14
522,0,0,0,0,1,3,0,1,0,0,0,5,0,10,6,16
523,0,0,0,0,1,2,2,2,0,0,0,0,0,7,6,13
524,0,0,1,2,0,4,1,7,2,5,0,2,0,24,8,32
531,0,0,0,0,0,1,0,0,0,0,0,1,0,2,3,5
532,0,0,0,1,0,2,0,1,0,1,3,4,0,12,7,19
533,0,0,0,0,0,4,0,2,1,1,1,0,0,9,3,12
534,0,0,0,0,0,0,0,0,0,1,0,0,0,1,2,3
541,0,0,0,0,0,1,0,0,1,0,0,1,0,3,6,9
542,0,0,0,0,0,0,0,0,0,0,0,0,0,0,3,3
543,0,0,0,0,0,0,0,0,0,1,0,0,0,1,0,1
544,0,0,0,0,0,2,0,0,1,1,0,0,0,4,4,8
545,0,0,0,0,2,0,0,2,0,0,0,1,0,5,3,8
546,0,0,0,1,0,0,1,2,0,0,1,0,0,5,4,9
551,0,0,0,0,0,0,2,2,0,1,1,0,0,6,3,9
552,0,0,0,0,0,1,0,0,0,2,0,0,0,3,6,9
553,0,0,0,0,2,0,1,0,0,4,1,0,0,8,2,10
554,0,0,0,0,1,0,0,1,1,2,0,1,0,6,2,8
561,0,0,0,0,2,1,0,3,1,3,0,3,0,13,1,14
562,0,0,0,0,0,1,1,0,1,2,0,2,0,7,0,7
563,0,0,0,0,0,0,0,0,0,0,0,0,0,0,1,1
571,0,0,0,1,0,5,1,1,0,1,5,2,0,16,9,25
572,0,0,1,1,0,7,1,0,1,6,3,0,0,20,5,25
581,0,0,0,0,0,1,0,1,0,2,0,1,0,5,0,5
582,0,0,1,0,0,3,0,2,0,1,0,1,0,8,0,8
583,0,0,0,1,0,1,1,1,2,2,1,1,0,10,5,15
584,0,0,0,0,0,1,0,0,1,1,2,0,0,5,0,5
591,0,0,0,0,0,3,0,0,0,0,1,2,0,6,0,6
592,0,0,0,0,0,0,0,1,1,0,0,0,0,2,0,2
593,0,0,0,0,0,2,0,0,1,2,0,0,0,5,0,5
595,0,0,0,0,0,0,0,0,0,0,0,0,0,0,0,0
596,0,0,0,0,0,0,0,0,0,0,1,0,0,1,2,3
601,0,0,0,0,0,2,2,1,0,1,0,1,0,7,2,9
602,0,0,0,1,0,2,0,2,3,2,0,2,0,12,3,15
603,0,0,0,0,0,0,1,1,0,0,1,0,0,3,0,3
604,0,0,0,0,0,0,1,2,0,0,0,0,1,4,2,6
610,0,0,0,0,0,0,0,0,0,0,1,0,0,1,1,2
621,0,0,0,1,0,0,2,0,1,1,0,0,0,5,4,9
622,0,0,0,0,0,3,0,2,1,4,0,0,0,10,2,12
623,0,0,0,0,0,0,0,1,0,3,1,2,0,7,3,10
624,0,0,0,0,0,0,0,1,0,1,0,0,0,2,2,4
625,0,0,0,0,0,0,0,0,0,0,0,0,0,0,0,0
631,0,0,0,0,0,0,0,1,0,0,0,1,0,2,0,2
632,0,0,0,0,0,0,0,2,0,0,0,1,0,3,3,6
633,0,0,0,0,0,1,0,2,0,0,0,1,0,4,0,4
634,0,0,0,0,1,0,4,6,2,10,0,1,0,24,3,27
635,0,0,0,1,0,0,0,0,1,0,1,0,0,3,0,3
636,0,0,0,0,0,0,0,0,0,0,0,0,0,0,1,1
641,0,0,0,1,0,0,0,1,1,0,0,0,0,3,0,3
642,0,0,0,0,0,0,0,0,1,0,0,0,0,1,1,2
643,0,0,0,1,0,0,0,1,0,1,0,0,0,3,1,4
644,0,0,0,0,0,0,0,0,0,3,0,0,0,3,2,5
645,0,0,0,0,0,0,0,1,1,1,0,0,1,4,2,6
646,0,0,0,0,0,0,0,1,0,1,0,0,0,2,1,3
651,0,0,0,0,0,0,0,1,0,3,0,1,0,5,4,9
652,0,0,0,0,0,0,0,0,0,0,0,0,0,0,1,1
653,0,0,0,0,0,0,1,0,0,6,0,1,0,8,4,12
654,0,0,0,0,0,0,0,1,0,4,0,1,0,6,9,15
655,0,0,0,0,0,0,1,4,1,1,0,0,0,7,0,7
661,0,0,0,0,0,0,0,0,0,0,0,1,0,1,2,3
662,0,0,0,0,0,0,1,2,4,5,0,0,0,12,2,14
663,0,0,0,0,0,0,0,2,0,0,0,0,0,2,0,2
664,0,0,0,0,0,1,0,1,0,0,1,1,0,4,0,4
665,0,0,0,0,0,1,0,0,0,0,0,0,0,1,0,1
671,0,0,0,0,0,1,0,1,0,2,0,0,0,4,0,4
672,0,0,0,0,1,0,0,2,1,0,0,2,0,6,3,9
674,0,0,0,0,0,0,0,01,0,0,0,0,0,01,04,05
675,0,0,0,0,01,0,0,0,0,0,01,01,0,03,04,07
676,0,0,0,01,0,0,0,01,0,0,0,01,0,03,01,04
681,0,0,0,0,0,0,0,04,01,0,0,0,0,05,00,05
682,0,0,0,0,0,01,0,01,0,0,0,0,0,02,01,03
683,0,0,0,0,0,0,0,0,0,0,0,0,0,00,01,01
684,0,0,0,0,0,0,0,0,0,01,0,0,0,01,00,01
685,0,0,0,0,0,0,0,0,0,0,0,01,0,01,02,03
686,0,0,0,0,0,0,0,0,0,01,0,0,0,01,00,01
687,0,0,0,0,0,0,0,0,01,02,0,0,0,03,00,03
688,0,0,0,0,0,0,0,02,01,0,0,0,0,03,01,04
689,0,0,0,0,0,0,0,0,0,0,0,0,0,00,01,01
691,0,0,0,0,0,0,0,0,01,0,0,0,0,01,00,01
692,0,0,0,0,0,02,0,01,0,01,0,0,0,04,02,06
693,0,0,0,0,0,0,0,0,0,0,0,0,0,00,03,03
694,0,0,0,0,0,0,0,0,0,0,0,0,0,00,02,02
695,0,0,0,0,0,0,0,02,01,05,01,02,0,011,01,012
800,0,0,0,0,01,0,0,0,0,01,02,0,0,04,013,017
801,0,0,0,0,0,0,0,0,0,0,0,0,0,00,00,00
821,0,0,0,0,0,0,0,0,0,0,0,0,0,00,00,00
822,0,0,0,0,0,0,0,0,0,0,0,0,0,00,00,00
823,0,0,0,0,0,0,0,0,0,0,0,0,0,00,00,00
824,0,0,0,0,0,0,0,0,0,0,0,0,0,00,00,00
825,0,0,0,0,0,0,0,0,0,0,0,0,0,00,01,01
962,0,0,0,0,0,0,0,0,0,0,0,0,0,00,00,00
Unk,0,0,0,0,0,0,0,0,0,0,0,0,0,00,02,02
