RD,MURDER,MANSLTR,FORCED_RAPE,ROBBERY,AGGRAV_ASSAULT,BURGLARY_RES,BURGLARY_COM,AUTO_BURG,GRAND_THEFT,PETTY_THEFT,BIKE_THEFT,AUTO_THEFT,ARSON,TOTAL_PART1,TOTAL_PART2,GRAND_TOTAL
010,0,0,0,0,0,0,0,0,0,0,0,0,0,0,0,0
020,0,0,0,1,0,0,1,0,2,0,0,0,0,4,1,5
021,0,0,0,0,0,0,0,0,0,0,0,0,0,0,0,0
030,0,0,0,0,0,0,0,0,0,1,0,0,0,1,0,1
031,0,0,0,0,0,0,0,0,0,0,0,0,0,0,0,0
041,0,0,0,0,0,0,0,0,0,0,0,1,0,1,0,1
042,0,1,0,0,0,0,1,0,1,0,0,0,0,3,0,3
043,0,0,0,0,0,0,0,0,0,0,0,0,0,0,0,0
044,0,0,0,0,0,0,0,0,0,0,0,0,0,0,0,0
051,0,0,0,0,0,4,0,1,0,0,0,1,0,6,1,7
052,0,0,0,0,0,1,0,0,0,1,1,0,0,3,9,12
053,0,0,1,0,1,0,0,0,1,1,0,0,0,4,9,13
061,0,0,0,1,1,3,0,1,0,0,0,2,0,8,4,12
062,0,0,0,1,2,1,0,0,0,1,0,0,0,5,1,6
063,0,0,0,0,0,0,0,0,0,0,1,0,0,1,1,2
064,0,0,0,3,1,4,0,0,1,1,0,0,0,10,1,11
071,0,0,0,0,2,0,0,0,2,0,0,2,0,6,11,17
072,0,0,0,2,0,2,1,4,1,1,0,0,1,12,3,15
073,0,0,0,1,0,4,0,2,1,1,0,2,0,11,5,16
074,0,0,0,0,0,1,0,0,0,1,0,1,0,3,1,4
075,0,0,0,0,0,0,0,0,1,1,0,0,0,2,7,9
076,0,0,0,0,0,1,0,0,1,0,0,2,0,4,3,7
081,0,0,0,0,1,0,0,0,0,3,0,0,0,4,10,14
082,0,0,0,1,0,1,1,5,1,5,5,2,0,21,6,27
083,0,0,0,0,0,0,0,1,0,0,0,0,0,1,0,1
084,0,0,0,0,0,0,0,0,0,1,0,1,0,2,4,6
085,0,0,0,0,0,0,0,3,0,0,0,1,0,4,1,5
091,0,0,0,0,0,0,0,1,0,1,0,1,0,3,7,10
092,0,0,0,0,0,2,0,0,1,3,1,1,0,8,3,11
093,0,0,0,0,0,0,0,0,1,1,2,1,0,5,4,9
094,0,0,0,0,1,2,0,0,0,1,0,0,0,4,6,10
101,0,0,0,1,3,2,1,1,0,0,0,0,0,8,3,11
102,0,0,0,0,0,0,0,1,0,0,0,3,0,4,6,10
104,0,0,0,0,0,0,0,0,2,0,0,0,1,3,1,4
111,0,0,0,0,0,0,0,0,0,0,0,2,0,2,9,11
112,0,0,0,0,2,0,0,1,0,2,1,0,0,6,14,20
113,0,0,0,0,0,0,0,0,0,0,1,0,0,1,0,1
114,0,0,1,0,0,0,0,0,0,1,0,0,0,2,2,4
121,0,0,0,0,0,0,0,1,0,1,0,1,0,3,4,7
122,0,0,0,3,1,1,0,0,1,0,0,0,1,7,13,20
123,0,0,0,0,1,0,0,0,0,1,0,0,0,2,0,2
124,0,0,0,0,0,0,0,0,0,1,0,1,0,2,0,2
131,0,0,0,1,0,0,0,1,0,0,0,0,0,2,2,4
132,0,0,0,0,0,0,0,1,1,2,0,1,0,5,8,13
133,0,0,0,0,0,2,0,0,0,0,0,0,0,2,1,3
134,0,0,0,0,0,2,0,0,2,1,0,0,0,5,1,6
141,0,0,0,1,0,5,0,1,1,1,0,5,0,14,1,15
142,0,0,0,0,0,6,0,1,1,0,0,0,0,8,2,10
143,0,0,0,0,0,2,0,0,0,1,0,0,0,3,1,4
144,0,0,0,0,0,3,0,1,0,0,0,0,0,4,4,8
151,0,0,0,0,0,0,0,0,1,2,0,0,0,3,2,5
152,0,0,0,1,0,2,2,0,6,3,0,1,0,15,2,17
153,0,0,0,1,2,0,0,0,1,2,3,0,0,9,7,16
161,0,0,0,0,1,0,1,6,0,4,0,0,0,12,4,16
162,0,0,0,1,0,0,0,3,0,1,1,2,0,8,4,12
163,0,0,0,1,0,0,1,1,0,2,0,0,0,5,10,15
164,0,0,0,2,0,0,10,0,1,13,3,0,0,29,8,37
171,0,0,0,0,2,0,2,1,1,1,0,2,0,9,4,13
172,0,0,0,1,0,2,0,2,1,2,2,1,0,11,5,16
173,0,0,0,0,1,1,0,2,2,1,0,0,0,7,6,13
174,0,0,0,2,4,0,1,3,1,3,0,0,0,14,6,20
181,0,0,0,3,1,0,0,0,0,1,0,0,0,5,5,10
182,0,0,0,1,3,0,0,0,2,1,0,1,0,8,10,18
183,0,0,0,0,0,1,0,1,1,1,0,0,0,4,6,10
184,0,0,0,0,0,2,1,0,1,2,1,4,0,11,12,23
191,0,0,0,1,2,0,0,0,1,4,0,1,0,9,1,10
192,0,0,0,1,0,0,0,0,1,1,0,1,0,4,2,6
193,0,0,0,0,3,0,0,0,0,0,0,0,0,3,7,10
194,0,0,0,0,1,0,0,0,2,1,0,0,0,4,13,17
202,0,0,0,0,0,1,0,0,0,1,0,1,0,3,2,5
203,0,0,0,1,0,0,0,0,0,2,0,0,0,3,4,7
204,0,0,0,0,1,0,0,3,2,1,0,0,0,7,5,12
211,0,0,0,0,0,0,0,2,1,1,0,0,0,4,0,4
212,0,0,0,0,0,0,0,2,1,1,0,0,0,4,6,10
213,0,0,0,1,0,0,0,0,1,0,0,0,0,2,0,2
214,0,0,0,0,1,0,2,0,2,4,0,1,0,10,4,14
215,0,0,0,0,0,1,0,2,0,0,0,0,0,3,3,6
216,0,0,0,0,0,0,0,0,1,0,0,1,0,2,3,5
221,0,0,0,1,0,1,1,0,0,0,0,0,0,3,5,8
222,0,0,0,1,0,0,0,0,1,0,0,0,0,2,4,6
223,0,0,0,0,0,0,2,0,1,1,0,1,0,5,0,5
224,0,0,0,1,0,2,0,1,1,1,0,1,0,7,4,11
225,0,0,0,0,0,0,0,1,0,0,0,0,0,1,3,4
226,0,0,0,0,0,3,0,0,0,1,0,-1,0,3,6,9
231,0,0,0,2,1,1,0,0,0,2,1,2,0,9,7,16
232,0,0,0,1,1,3,1,4,2,0,0,1,0,13,6,19
233,0,0,0,0,0,1,2,0,0,1,0,1,0,5,11,16
234,0,0,0,0,0,1,0,1,0,0,0,0,0,2,4,6
235,0,0,0,1,0,3,0,0,0,1,0,3,0,8,6,14
241,0,0,1,2,0,1,0,0,0,0,0,2,0,6,2,8
242,0,0,0,2,0,5,1,1,1,0,0,4,0,14,8,22
243,0,0,0,0,2,1,2,2,0,0,0,0,0,7,2,9
244,0,0,0,1,4,2,0,0,1,0,0,2,1,11,5,16
251,0,0,1,1,0,3,1,0,0,0,0,0,0,6,5,11
252,0,0,0,1,2,2,0,0,0,3,1,0,0,9,6,15
253,0,0,0,0,0,0,0,1,1,0,0,0,0,2,7,9
271,0,0,0,3,3,0,0,4,0,0,0,1,0,11,5,16
272,0,0,0,0,1,1,0,0,0,0,1,0,0,3,10,13
273,0,0,0,1,1,0,0,0,0,5,0,1,0,8,6,14
274,0,0,0,0,0,1,0,2,0,0,0,1,0,4,4,8
281,0,0,0,0,1,0,0,1,0,0,1,1,0,4,6,10
282,0,0,0,3,1,1,0,3,0,0,0,1,0,9,6,15
291,0,0,1,1,0,1,0,2,0,1,0,0,0,6,3,9
292,1,0,2,1,0,2,0,0,4,0,0,0,0,10,6,16
293,0,0,1,0,1,1,0,1,0,0,0,2,0,6,7,13
301,0,0,0,0,0,0,0,0,0,0,0,0,0,0,4,4
302,0,0,0,0,0,0,0,1,0,1,0,1,0,3,2,5
303,0,0,0,1,0,1,2,2,1,1,1,0,0,9,2,11
304,0,0,0,0,0,0,0,0,0,0,0,0,0,0,6,6
311,0,0,0,0,0,0,0,1,0,0,0,0,0,1,1,2
312,0,0,0,1,0,1,0,0,0,1,0,0,0,3,1,4
313,0,0,0,0,0,0,0,1,0,1,0,0,0,2,4,6
314,0,0,0,0,0,1,0,0,0,0,0,1,0,2,2,4
315,0,0,0,1,1,1,0,2,0,2,0,0,0,7,2,9
316,0,0,0,1,2,2,0,1,2,0,0,1,0,9,1,10
321,0,0,0,0,0,1,1,1,0,0,0,0,0,3,2,5
322,0,0,0,0,0,0,0,1,2,2,0,0,0,5,1,6
323,0,0,0,0,0,0,0,0,0,0,0,0,0,0,0,0
331,0,0,0,4,0,2,0,1,0,1,0,2,0,10,4,14
332,0,0,0,1,0,1,0,0,0,0,0,0,0,2,3,5
333,0,0,0,1,0,1,1,0,2,2,0,0,0,7,1,8
334,0,0,0,2,0,0,0,0,0,1,0,1,0,4,1,5
335,0,0,0,0,0,0,1,1,0,1,0,0,0,3,3,6
336,0,0,0,0,1,0,0,0,0,0,0,0,0,1,6,7
341,0,0,0,0,0,7,0,2,2,4,0,1,0,16,6,22
342,0,0,0,3,0,0,0,0,4,2,1,2,1,13,13,26
343,0,0,0,1,0,3,0,1,1,1,0,0,0,7,10,17
351,0,0,0,0,0,7,0,6,2,1,1,2,0,19,3,22
352,0,0,0,0,1,3,0,2,0,2,2,2,0,12,2,14
353,0,0,0,0,0,1,0,0,0,1,1,3,0,6,3,9
354,0,0,0,0,0,1,0,1,0,2,0,0,0,4,1,5
361,0,0,1,3,1,1,0,0,1,1,1,1,0,10,7,17
362,0,0,1,1,1,0,1,4,1,0,0,1,0,10,4,14
371,0,0,0,0,0,0,0,2,0,0,0,0,0,2,5,7
372,0,0,0,1,1,2,0,2,0,1,0,2,0,9,2,11
373,0,0,0,0,2,0,0,0,0,0,0,1,1,4,6,10
374,0,0,0,0,3,1,0,1,0,0,0,1,0,6,6,12
381,0,0,0,0,0,-1,0,1,0,2,0,1,0,3,5,8
382,0,0,0,1,0,0,0,0,0,1,0,1,0,3,2,5
383,0,0,0,0,2,1,0,0,0,0,0,1,0,4,6,10
384,0,0,0,1,1,1,0,0,0,0,0,0,0,3,5,8
392,0,0,0,2,1,0,0,0,1,0,0,0,0,4,4,8
393,0,0,0,0,0,0,0,0,3,3,1,1,0,8,2,10
401,0,0,0,0,0,1,0,0,1,2,0,0,0,4,0,4
402,0,0,0,0,0,2,0,0,0,1,0,1,0,4,3,7
403,0,0,0,0,0,0,0,0,0,0,0,0,0,0,2,2
411,0,0,0,0,0,0,1,0,1,1,0,0,0,3,5,8
412,0,0,0,0,0,1,0,0,2,1,0,1,0,5,2,7
413,0,0,0,0,0,1,0,1,0,0,0,3,0,5,2,7
414,0,0,0,0,0,0,1,1,1,2,2,0,0,7,4,11
415,0,0,0,0,0,1,2,4,1,0,0,2,0,10,2,12
421,0,0,0,2,1,0,0,0,0,2,0,1,0,6,2,8
422,0,0,0,2,1,1,0,2,0,0,1,1,0,8,1,9
423,0,0,0,0,1,0,0,2,0,0,0,2,0,5,5,10
431,0,0,0,0,0,1,0,1,1,0,0,0,0,3,2,5
432,0,0,0,0,0,0,0,0,1,0,0,0,0,1,0,1
433,0,0,0,0,0,0,0,0,0,0,0,0,0,0,7,7
434,0,0,0,0,0,0,0,3,1,0,1,3,0,8,0,8
441,0,0,0,0,0,0,0,1,0,1,2,0,0,4,2,6
442,0,0,0,0,0,0,0,3,0,0,0,2,0,5,1,6
451,1,0,0,0,1,0,0,1,0,0,1,0,0,4,5,9
452,0,0,0,0,0,1,0,2,0,0,1,0,0,4,1,5
453,0,0,0,2,0,0,0,5,0,0,1,0,0,8,2,10
454,0,0,0,0,0,2,0,2,0,1,0,0,1,6,11,17
461,0,0,0,0,0,0,1,2,0,1,0,1,0,5,2,7
462,0,0,0,0,0,0,0,0,1,1,0,0,0,2,3,5
463,0,0,0,1,0,1,0,2,0,0,0,0,0,4,5,9
464,0,0,0,0,2,1,0,3,1,1,0,3,0,11,11,22
470,0,0,0,0,0,0,0,0,0,0,0,0,0,0,2,2
471,0,0,0,0,0,0,0,0,0,0,0,0,0,0,4,4
472,0,0,0,0,0,0,0,0,0,0,0,0,0,0,1,1
473,0,0,0,0,0,0,0,2,0,0,0,0,0,2,2,4
474,0,0,0,0,0,0,0,0,0,0,0,0,0,0,0,0
481,0,0,0,0,0,0,0,0,0,1,0,2,0,3,0,3
482,0,0,0,0,1,0,0,0,0,1,0,1,0,3,3,6
483,0,0,0,0,0,0,0,0,0,1,0,0,0,1,2,3
491,0,0,0,0,0,2,0,1,0,0,0,1,0,4,1,5
493,0,0,0,0,0,1,0,3,1,1,0,0,0,6,1,7
501,0,0,0,0,2,2,1,0,0,7,1,1,0,14,12,26
502,0,0,0,0,0,2,0,0,0,0,0,1,0,3,3,6
503,0,0,0,0,0,1,0,2,1,2,0,1,0,7,0,7
511,0,0,0,1,0,0,0,1,1,2,1,2,0,8,8,16
512,0,0,0,0,0,1,0,2,0,0,0,1,1,5,2,7
521,0,0,0,4,1,1,0,1,0,1,0,1,0,9,7,16
522,0,0,0,0,1,3,0,0,0,0,0,1,0,5,1,6
523,0,0,0,0,0,1,4,4,4,0,1,1,0,15,3,18
524,0,0,0,1,5,2,0,3,0,0,0,2,0,13,12,25
531,0,0,0,0,0,1,0,0,1,0,0,0,0,2,0,2
532,0,0,0,2,0,2,0,0,0,4,1,0,1,10,4,14
533,0,0,0,0,0,1,1,0,0,1,0,1,0,4,4,8
534,0,0,0,0,0,1,0,2,0,1,0,0,0,4,0,4
541,0,0,0,0,0,0,1,2,1,0,0,1,0,5,1,6
542,0,0,0,0,0,0,0,0,1,0,0,0,0,1,1,2
543,0,0,0,0,0,1,0,0,1,0,0,0,0,2,2,4
544,0,0,0,0,0,0,0,1,1,2,0,0,0,4,2,6
545,0,0,0,0,1,1,0,0,1,0,0,1,0,4,6,10
546,0,0,0,1,1,0,0,3,2,2,0,1,0,10,2,12
551,0,0,0,0,0,1,0,1,1,0,0,0,0,3,3,6
552,0,0,0,0,0,0,0,0,0,0,0,0,0,0,4,4
553,0,0,0,0,0,0,0,1,0,1,1,3,0,6,2,8
554,0,0,0,0,0,1,0,2,0,0,0,0,0,3,2,5
561,0,0,0,0,0,0,0,4,2,0,0,2,0,8,3,11
562,0,0,0,0,1,1,3,3,1,0,1,-1,0,9,4,13
563,0,0,0,0,0,1,0,0,1,0,0,0,0,2,1,3
571,0,0,0,1,1,2,0,1,1,1,1,0,0,8,6,14
572,0,0,0,0,0,1,0,0,3,3,0,0,0,7,5,12
581,0,0,0,0,0,2,0,0,0,0,0,0,0,2,1,3
582,0,0,0,0,1,3,0,1,0,0,4,0,0,9,0,9
583,0,0,0,1,0,1,1,0,1,3,0,0,0,7,4,11
584,0,0,0,0,0,1,0,0,0,0,0,0,0,1,0,1
591,0,0,0,0,0,0,0,1,0,0,1,0,0,2,2,4
592,0,0,0,0,0,1,0,0,0,2,0,0,0,3,1,4
593,0,0,0,0,0,0,0,0,0,0,0,1,0,1,1,2
595,0,0,0,0,0,0,0,0,0,0,0,0,0,0,0,0
596,0,0,0,0,0,0,0,0,0,0,0,0,0,0,3,3
601,0,0,0,0,0,1,0,1,0,2,0,0,0,4,4,8
602,0,0,0,0,2,1,0,4,0,4,0,1,0,12,11,23
603,0,0,0,0,0,1,0,0,0,1,0,1,0,3,8,11
604,0,0,0,0,0,1,0,3,0,1,0,0,0,5,1,6
610,0,0,0,0,0,1,1,0,0,0,0,0,0,2,3,5
621,0,0,0,0,0,0,0,1,1,1,0,0,0,3,2,5
622,0,0,0,0,0,3,0,0,3,0,0,1,0,7,5,12
623,0,0,0,0,1,0,1,0,1,1,0,0,0,4,2,6
624,0,0,0,0,0,0,0,0,0,2,0,0,0,2,1,3
625,0,0,0,0,0,0,0,1,0,0,0,0,0,1,1,2
631,0,0,0,0,0,2,0,0,2,0,0,0,0,4,0,4
632,0,0,0,0,0,2,2,0,1,2,0,0,0,7,0,7
633,0,0,0,0,0,0,0,0,1,2,0,0,0,3,2,5
634,0,0,0,1,1,0,0,1,2,5,0,1,0,11,4,15
635,0,0,0,0,0,0,0,0,0,0,0,0,0,0,0,0
636,0,0,0,0,0,0,0,0,0,0,0,0,0,0,0,0
641,0,0,0,0,0,0,0,4,0,0,0,0,0,4,0,4
642,0,0,0,0,0,2,0,0,0,1,0,0,0,3,3,6
643,0,0,0,0,0,0,1,0,4,0,0,0,0,5,1,6
644,0,0,0,0,0,0,0,0,2,3,0,0,0,5,7,12
645,0,0,0,0,0,0,0,1,0,0,0,0,0,1,2,3
646,0,0,0,0,0,0,0,0,0,0,0,0,0,0,0,0
651,0,0,0,1,0,0,0,3,1,1,0,0,0,6,2,8
652,0,0,0,0,0,0,0,0,0,1,0,0,0,1,1,2
653,0,0,0,0,0,1,0,0,0,4,1,0,0,6,8,14
654,0,0,0,0,0,1,0,0,1,4,0,0,0,6,4,10
655,0,0,0,0,0,0,0,1,0,0,0,0,0,1,2,3
661,0,0,0,0,0,1,0,0,1,0,0,0,0,2,1,3
662,0,0,0,0,1,0,0,1,1,0,0,1,0,4,5,9
663,0,0,0,1,0,0,0,0,0,1,0,0,0,2,5,7
664,0,0,0,0,0,0,0,1,1,1,0,0,0,3,5,8
665,0,0,0,0,0,2,0,0,1,2,0,0,0,5,3,8
671,0,0,0,0,0,0,1,1,0,0,0,0,0,2,3,5
672,0,0,0,0,0,3,0,3,2,0,0,0,0,8,0,8
674,0,0,0,0,0,0,0,0,01,0,0,0,0,01,01,02
675,0,0,0,0,0,0,01,02,02,04,0,01,0,010,04,014
676,0,0,0,0,01,0,0,01,0,0,0,0,0,02,02,04
681,0,0,0,0,0,0,0,0,0,0,0,0,0,00,02,02
682,0,0,0,0,0,01,0,0,0,0,0,0,0,01,00,01
683,0,0,0,0,0,0,0,01,0,0,0,0,0,01,00,01
684,0,0,0,0,0,0,0,0,0,01,0,0,0,01,02,03
685,0,0,0,0,0,0,0,0,01,0,0,0,0,01,01,02
686,0,0,0,0,0,02,0,0,0,01,0,0,0,03,00,03
687,0,0,0,0,0,0,0,0,0,0,0,0,0,00,00,00
688,0,0,0,0,0,01,0,0,0,0,0,0,0,01,01,02
689,0,0,0,0,0,0,0,0,0,0,0,0,0,00,02,02
691,0,0,0,0,0,0,0,0,0,0,0,0,0,00,00,00
692,0,0,0,0,0,03,0,06,01,06,0,01,0,017,02,019
693,0,0,0,0,0,0,0,03,01,01,0,0,0,05,00,05
694,0,0,0,0,0,0,0,0,0,0,0,0,0,00,02,02
695,0,0,0,01,01,0,0,0,02,08,02,05,0,019,04,023
800,0,0,0,0,0,01,0,0,0,01,0,01,0,03,09,012
801,0,0,0,0,0,0,0,0,0,0,0,0,0,00,00,00
821,0,0,0,0,0,0,0,0,0,0,0,0,0,00,00,00
822,0,0,0,0,0,0,0,0,0,0,0,0,0,00,00,00
823,0,0,0,0,0,0,0,0,0,0,0,0,0,00,00,00
824,0,0,0,0,0,0,0,0,0,0,0,0,0,00,00,00
825,0,0,0,0,0,0,0,0,0,0,0,0,0,00,00,00
962,0,0,0,0,0,0,0,0,0,0,0,0,0,00,00,00
Unk,0,0,0,0,0,0,0,0,01,0,0,0,0,01,03,04
