RD,MURDER,MANSLTR,FORCED_RAPE,ROBBERY,AGGRAV_ASSAULT,BURGLARY_RES,BURGLARY_COM,AUTO_BURG,GRAND_THEFT,PETTY_THEFT,BIKE_THEFT,AUTO_THEFT,ARSON,TOTAL_PART1,TOTAL_PART2,GRAND_TOTAL
010,0,0,0,0,0,0,0,0,0,0,0,0,0,0,1,1
020,0,0,0,0,0,1,0,0,1,1,0,1,0,4,2,6
021,0,0,0,0,0,0,0,0,0,0,0,0,0,0,1,1
030,0,0,0,0,0,0,0,0,3,0,0,0,0,3,1,4
031,0,0,0,0,0,0,0,0,0,0,0,0,0,0,0,0
041,0,0,0,0,0,0,1,1,0,1,0,0,0,3,1,4
042,0,0,0,0,0,0,0,0,0,0,0,0,0,0,1,1
043,0,0,0,0,0,0,0,0,0,1,0,0,0,1,1,2
044,0,0,0,0,0,0,0,1,0,1,0,0,0,2,0,2
051,0,0,0,1,1,1,1,0,0,0,0,0,0,4,2,6
052,0,0,0,3,0,1,0,0,0,0,0,0,0,4,6,10
053,0,0,0,1,0,0,0,0,0,2,0,0,0,3,12,15
061,0,0,0,0,0,1,0,1,2,0,0,1,0,5,3,8
062,0,0,0,0,1,2,0,1,0,3,0,1,0,8,2,10
063,0,0,0,0,0,2,0,0,0,0,0,1,0,3,1,4
064,0,0,0,0,0,0,1,0,2,0,0,1,0,4,0,4
071,0,0,0,0,1,0,0,1,0,0,0,0,0,2,5,7
072,0,0,0,1,4,0,0,1,0,3,0,2,0,11,9,20
073,0,0,0,0,1,1,0,1,0,2,0,2,0,7,3,10
074,0,0,0,0,0,0,0,0,0,0,0,1,0,1,0,1
075,0,0,0,0,2,1,0,0,0,1,0,0,0,4,5,9
076,0,0,0,0,0,1,0,0,0,1,0,2,0,4,1,5
081,0,0,0,0,1,0,0,0,0,1,4,1,0,7,12,19
082,0,0,0,1,3,2,0,4,1,3,1,2,0,17,7,24
083,0,0,1,0,0,0,0,0,0,0,0,0,0,1,0,1
084,0,0,0,0,0,0,0,0,1,0,0,0,0,1,1,2
085,0,0,0,0,0,0,0,1,0,1,0,0,0,2,0,2
091,0,0,0,3,1,1,1,1,0,1,2,2,0,12,5,17
092,0,0,0,0,2,1,0,0,0,2,1,0,0,6,8,14
093,0,0,0,0,0,0,0,0,0,0,0,2,0,2,0,2
094,0,0,0,1,0,0,0,1,1,1,0,0,0,4,6,10
101,0,0,0,0,0,1,0,0,2,1,1,2,0,7,7,14
102,0,0,0,1,5,2,0,0,1,3,0,1,0,13,8,21
104,0,0,0,0,1,0,0,0,0,0,1,0,0,2,2,4
111,0,0,0,1,1,6,0,2,0,4,0,0,0,14,3,17
112,0,0,0,0,3,1,0,0,1,2,0,2,0,9,8,17
113,0,0,0,0,1,0,1,0,0,0,0,1,0,3,2,5
114,0,0,0,0,0,0,1,0,0,1,0,1,0,3,3,6
121,0,0,0,0,1,1,0,1,0,4,0,4,0,11,3,14
122,0,0,0,2,4,7,0,1,1,1,0,1,0,17,7,24
123,0,0,0,0,1,4,0,1,0,4,0,0,0,10,1,11
124,0,0,0,0,0,3,0,0,0,0,0,3,0,6,0,6
131,0,0,0,0,0,0,0,2,0,0,0,0,0,2,4,6
132,0,0,0,0,0,3,0,1,0,0,0,2,0,6,7,13
133,0,0,0,0,0,1,0,0,0,0,0,0,0,1,0,1
134,0,0,0,0,0,1,1,0,0,0,0,1,0,3,1,4
141,0,0,0,0,0,2,0,1,0,2,0,1,0,6,0,6
142,0,0,0,0,0,3,1,3,0,3,1,0,0,11,2,13
143,0,0,0,0,0,4,0,0,2,0,0,0,0,6,1,7
144,0,0,0,0,0,1,0,1,0,0,0,0,0,2,1,3
151,0,0,0,0,0,0,0,1,0,3,0,1,0,5,4,9
152,0,0,1,0,3,0,4,9,2,2,3,0,0,24,6,30
153,0,0,0,0,0,0,0,2,1,1,0,0,0,4,7,11
161,0,0,0,2,2,1,1,1,3,0,2,0,0,12,10,22
162,0,0,0,0,0,0,0,0,0,1,0,1,0,2,3,5
163,0,0,0,0,0,1,0,0,1,3,1,0,0,6,6,12
164,0,0,0,3,1,2,5,1,1,13,5,2,0,33,6,39
171,1,0,0,1,0,0,2,1,0,1,0,0,0,6,1,7
172,0,0,0,2,0,1,0,2,0,1,0,0,0,6,6,12
173,0,0,0,2,0,1,1,0,1,0,0,1,0,6,12,18
174,0,0,0,1,0,0,0,1,0,5,0,1,0,8,5,13
181,0,0,0,1,1,2,1,1,0,2,0,1,0,9,7,16
182,0,0,0,2,2,0,0,0,0,0,0,1,1,6,6,12
183,0,0,0,1,2,0,0,0,0,1,0,2,0,6,4,10
184,0,0,0,0,0,1,0,0,0,0,0,0,0,1,6,7
191,0,0,0,0,0,0,0,0,0,1,1,0,0,2,4,6
192,0,0,0,0,0,0,0,1,1,0,0,0,0,2,3,5
193,0,0,1,0,0,2,0,0,0,4,1,0,0,8,6,14
194,0,0,0,0,1,0,0,0,0,0,0,0,0,1,7,8
202,0,0,0,0,0,0,0,1,1,0,0,3,0,5,0,5
203,0,0,0,2,2,0,0,0,1,2,0,3,0,10,4,14
204,0,0,0,2,0,0,0,0,1,2,0,0,0,5,2,7
211,0,0,0,0,0,0,0,3,0,1,0,0,0,4,3,7
212,0,0,0,0,0,0,0,0,0,1,0,0,0,1,8,9
213,0,0,0,1,1,0,0,0,0,1,0,1,0,4,1,5
214,0,0,0,2,0,0,3,0,0,2,1,0,0,8,3,11
215,0,0,0,0,0,0,0,0,0,1,0,1,0,2,1,3
216,0,0,0,0,0,1,1,0,0,0,0,0,0,2,2,4
221,0,0,0,1,0,4,0,0,0,1,1,1,0,8,3,11
222,0,0,1,0,0,1,1,0,0,1,0,0,0,4,3,7
223,0,0,0,2,0,6,0,2,1,0,1,0,0,12,2,14
224,0,0,0,1,1,5,0,2,0,2,0,0,1,12,2,14
225,0,0,0,0,0,0,0,1,0,0,0,0,0,1,2,3
226,0,0,0,1,0,1,0,2,1,3,0,0,0,8,5,13
231,0,0,0,3,0,3,0,1,0,2,0,3,0,12,7,19
232,0,0,1,0,1,4,0,0,0,4,1,-1,0,10,13,23
233,0,0,0,0,1,6,0,1,0,1,0,3,0,12,4,16
234,0,0,0,0,0,0,0,0,1,1,0,1,0,3,3,6
235,1,0,0,3,4,2,0,0,0,0,1,2,0,13,5,18
241,0,0,1,1,1,0,0,2,0,1,0,3,0,9,0,9
242,0,0,1,0,1,4,0,1,0,2,0,6,0,15,8,23
243,0,0,0,2,0,1,0,1,1,0,1,2,0,8,4,12
244,0,0,0,0,3,0,2,5,0,1,0,3,0,14,2,16
251,0,0,0,0,0,2,0,0,0,1,1,1,0,5,7,12
252,0,0,0,0,0,1,0,3,0,2,0,2,0,8,4,12
253,0,0,0,3,0,0,4,3,2,1,0,0,0,13,4,17
271,0,0,0,0,0,2,0,1,0,2,0,3,0,8,6,14
272,0,0,0,0,0,3,0,2,1,2,2,1,0,11,10,21
273,0,0,0,0,2,0,0,2,0,2,1,0,0,7,9,16
274,0,0,0,1,2,0,0,0,0,0,1,0,0,4,6,10
281,0,0,0,1,1,1,0,1,1,2,0,1,0,8,9,17
282,0,0,0,0,0,0,0,0,0,3,0,1,0,4,5,9
291,0,0,0,1,2,0,0,0,0,1,0,3,0,7,3,10
292,0,0,0,0,1,0,0,1,1,0,0,1,0,4,8,12
293,0,0,1,1,0,0,0,0,0,2,1,2,0,7,5,12
301,0,0,0,0,4,2,0,1,0,2,0,0,0,9,5,14
302,0,0,0,2,0,0,0,1,0,0,0,0,0,3,1,4
303,0,0,0,0,1,1,0,0,0,0,0,0,0,2,5,7
304,0,0,0,1,0,0,0,0,0,1,0,0,0,2,9,11
311,0,0,0,0,0,0,0,0,0,1,0,0,0,1,1,2
312,0,0,0,0,0,2,0,0,0,1,0,0,1,4,4,8
313,0,0,0,0,0,0,0,0,0,0,0,0,0,0,4,4
314,0,0,0,0,1,1,0,0,0,2,0,1,0,5,5,10
315,0,0,0,0,1,1,0,0,1,0,0,0,0,3,2,5
316,0,0,0,0,0,0,0,1,0,1,0,0,0,2,5,7
321,0,0,0,0,0,1,0,0,0,0,0,1,0,2,1,3
322,0,0,0,0,0,1,0,0,0,1,0,0,0,2,2,4
323,0,0,0,0,0,0,0,0,0,0,0,0,1,1,1,2
331,0,0,0,2,2,3,1,0,0,1,0,2,0,11,4,15
332,0,0,0,0,0,0,0,0,0,0,0,0,0,0,3,3
333,0,0,0,1,0,0,0,0,0,6,1,1,0,9,5,14
334,0,0,0,0,0,2,0,0,0,2,0,1,0,5,3,8
335,0,0,0,0,0,0,0,0,0,0,0,1,0,1,1,2
336,0,0,0,1,0,1,1,0,0,0,1,0,0,4,2,6
341,0,0,0,2,0,3,2,0,0,2,0,9,0,18,6,24
342,0,0,0,0,0,3,1,3,0,1,1,1,0,10,14,24
343,0,0,0,1,0,3,0,1,1,4,1,1,0,12,4,16
351,0,0,0,0,0,0,0,0,0,3,1,3,0,7,4,11
352,0,0,0,1,1,1,0,0,0,7,0,1,0,11,10,21
353,0,0,0,0,2,3,0,1,1,0,1,1,0,9,12,21
354,0,0,0,0,2,0,0,0,1,3,0,1,0,7,9,16
361,0,0,0,1,3,4,1,1,0,2,2,0,0,14,7,21
362,0,0,0,0,1,0,0,2,1,3,1,2,0,10,8,18
371,1,0,0,0,1,0,0,0,0,0,0,1,0,3,3,6
372,0,0,0,1,1,0,0,2,1,2,1,1,0,9,9,18
373,0,0,0,1,0,1,0,0,0,2,0,0,0,4,5,9
374,0,0,0,0,1,1,0,0,0,2,0,2,0,6,5,11
381,0,0,0,1,4,1,0,0,0,2,0,1,0,9,0,9
382,0,0,0,2,0,3,0,1,0,0,0,0,0,6,3,9
383,0,0,0,0,0,2,0,0,0,0,1,0,1,4,4,8
384,0,0,0,1,0,1,1,0,0,1,0,0,0,4,1,5
392,0,0,0,0,0,0,1,0,1,0,0,1,0,3,2,5
393,0,0,0,0,0,0,0,0,0,0,0,0,0,0,1,1
401,0,0,0,0,0,2,0,0,0,3,0,0,0,5,2,7
402,0,0,0,0,0,1,0,0,0,0,0,1,0,2,1,3
403,0,0,0,0,0,0,0,0,0,0,0,0,0,0,0,0
411,0,0,0,3,0,2,1,0,0,2,0,0,0,8,7,15
412,0,0,1,0,0,1,0,0,1,0,0,0,0,3,0,3
413,0,0,0,0,0,0,0,1,1,2,0,2,1,7,4,11
414,0,0,0,0,1,4,1,1,0,0,0,2,0,9,9,18
415,0,0,0,0,0,1,0,0,0,1,0,1,0,3,4,7
421,0,0,0,1,0,2,1,0,1,3,0,3,0,11,4,15
422,0,0,0,1,0,0,0,0,0,3,0,2,0,6,5,11
423,0,0,0,1,3,0,0,0,0,2,0,4,0,10,8,18
431,0,0,0,0,3,0,0,0,0,2,0,0,0,5,1,6
432,0,0,0,0,1,0,0,0,0,0,0,0,0,1,0,1
433,0,0,0,0,0,2,0,0,0,1,0,0,0,3,3,6
434,0,0,0,1,0,1,0,1,0,3,1,0,0,7,3,10
441,0,0,0,0,1,0,0,0,1,0,0,1,0,3,5,8
442,0,0,0,0,0,4,0,0,0,1,1,1,0,7,4,11
451,0,0,0,0,0,2,0,4,0,1,0,1,0,8,5,13
452,0,0,0,0,0,3,0,0,0,0,0,4,0,7,3,10
453,0,0,0,0,0,5,0,0,0,1,1,2,0,9,5,14
454,0,0,0,1,1,1,0,1,0,0,0,1,0,5,7,12
461,0,0,0,1,1,0,0,0,0,0,0,0,0,2,0,2
462,0,0,0,0,0,2,0,0,0,1,1,0,0,4,7,11
463,0,0,0,1,8,1,0,0,0,0,0,0,0,10,3,13
464,0,0,0,0,4,0,0,1,0,1,0,2,1,9,8,17
470,0,0,0,0,0,0,0,0,0,0,0,1,0,1,0,1
471,0,0,0,0,0,0,0,0,1,1,0,2,0,4,2,6
472,0,0,0,0,0,0,0,0,0,0,0,0,0,0,0,0
473,0,0,0,0,0,0,0,0,0,0,0,0,0,0,0,0
474,0,0,0,0,0,0,0,0,0,0,0,0,0,0,0,0
481,0,0,0,1,2,0,3,0,1,5,0,2,0,14,3,17
482,0,0,0,0,0,0,0,1,0,0,0,0,0,1,0,1
483,0,0,0,0,0,0,0,0,0,1,0,1,0,2,1,3
491,0,0,0,0,0,1,0,0,1,1,0,2,0,5,2,7
493,0,0,0,0,0,0,0,1,0,0,1,0,0,2,0,2
501,0,0,1,1,0,2,0,0,0,4,2,0,1,11,1,12
502,0,0,0,0,0,1,1,0,0,1,1,1,0,5,4,9
503,0,0,0,0,0,1,0,1,0,0,1,1,0,4,6,10
511,0,0,0,0,1,5,0,0,0,0,0,2,0,8,11,19
512,0,0,0,1,0,2,0,0,2,0,0,0,0,5,3,8
521,0,0,0,4,1,1,1,0,1,0,0,1,1,10,8,18
522,0,0,1,2,0,1,1,2,1,0,0,1,0,9,7,16
523,0,0,0,2,0,0,3,1,2,0,0,1,0,9,6,15
524,0,0,0,1,3,1,0,6,0,1,1,2,0,15,12,27
531,0,0,0,0,0,1,0,3,1,0,1,0,0,6,2,8
532,0,0,1,0,0,3,0,0,1,0,1,1,0,7,3,10
533,0,0,0,0,0,4,0,0,0,0,0,1,0,5,5,10
534,0,0,0,0,0,0,0,0,0,2,0,1,0,3,3,6
541,0,0,0,1,1,2,0,0,0,1,0,2,0,7,6,13
542,0,0,0,0,0,1,0,0,0,0,0,0,0,1,2,3
543,0,0,0,1,0,1,0,1,0,0,2,1,0,6,2,8
544,0,0,0,0,1,0,0,0,1,0,0,1,0,3,3,6
545,0,0,0,0,0,0,0,2,0,3,0,0,1,6,1,7
546,0,0,0,0,0,0,0,0,1,1,0,2,0,4,7,11
551,0,0,0,0,0,0,0,2,0,1,0,0,0,3,2,5
552,0,0,0,0,0,0,0,0,0,0,0,0,0,0,1,1
553,0,0,0,1,0,0,0,0,0,0,0,1,0,2,4,6
554,0,0,0,0,0,0,0,3,0,1,0,0,0,4,4,8
561,0,0,0,0,0,3,0,0,0,0,0,0,0,3,2,5
562,0,0,0,0,0,4,2,1,0,10,1,0,0,18,3,21
563,0,0,0,0,0,1,0,1,0,0,1,1,0,4,1,5
571,0,0,0,1,2,1,0,1,0,4,3,2,0,14,5,19
572,0,0,0,0,0,0,0,0,3,4,1,0,0,8,6,14
581,0,0,0,0,0,0,0,0,1,0,0,0,0,1,1,2
582,0,0,0,0,0,1,0,1,0,0,0,0,0,2,4,6
583,0,0,0,0,1,1,2,2,2,1,1,0,0,10,9,19
584,0,0,0,0,0,1,0,1,0,0,0,0,0,2,3,5
591,0,0,0,0,0,0,0,0,0,0,1,1,0,2,1,3
592,0,0,0,0,0,0,0,1,0,1,0,0,0,2,0,2
593,0,0,0,0,0,2,0,1,0,0,0,0,0,3,1,4
595,0,0,0,0,0,0,0,0,0,0,0,0,0,0,0,0
596,0,0,0,0,0,0,0,0,0,1,0,1,0,2,3,5
601,0,0,0,0,0,2,0,1,0,0,0,0,0,3,2,5
602,0,0,0,0,0,1,0,2,0,1,0,2,0,6,6,12
603,0,0,0,0,1,0,0,0,1,1,0,0,0,3,12,15
604,0,0,0,0,1,1,0,0,0,0,0,0,0,2,1,3
610,0,0,0,0,1,2,1,0,0,1,0,0,0,5,2,7
621,0,0,0,1,0,0,2,0,1,1,0,0,0,5,6,11
622,0,0,0,0,1,2,0,0,1,4,0,1,0,9,7,16
623,0,0,0,0,0,0,0,0,0,0,0,0,0,0,1,1
624,0,0,0,0,0,0,0,0,0,0,0,0,0,0,3,3
625,0,0,0,0,0,0,0,0,0,0,0,0,0,0,0,0
631,0,0,0,0,0,0,0,0,0,0,0,0,0,0,0,0
632,0,0,0,0,0,0,0,0,0,1,0,0,0,1,4,5
633,0,0,0,0,1,0,0,0,0,1,0,0,0,2,1,3
634,0,0,0,0,1,1,2,5,1,3,0,2,0,15,5,20
635,0,0,0,0,0,0,0,0,0,0,0,0,0,0,1,1
636,0,0,0,0,0,0,0,0,0,0,0,0,0,0,2,2
641,0,0,0,0,0,0,0,1,1,2,0,1,0,5,0,5
642,0,0,0,0,0,1,0,0,0,2,0,1,0,4,4,8
643,0,0,0,0,0,1,1,2,0,2,0,0,0,6,2,8
644,0,0,0,0,0,0,0,0,1,1,0,3,1,6,2,8
645,0,0,0,0,0,0,1,1,0,0,0,0,0,2,1,3
646,0,0,0,0,0,0,0,0,0,0,0,0,0,0,2,2
651,0,0,0,0,0,1,0,0,0,2,0,2,0,5,2,7
652,0,0,0,0,2,0,0,0,0,0,0,0,0,2,3,5
653,0,0,0,0,0,3,0,3,0,2,1,1,0,10,4,14
654,0,0,0,0,1,0,0,4,1,7,1,0,0,14,5,19
655,0,0,0,0,0,0,4,3,1,0,0,1,0,9,1,10
661,0,0,0,0,0,0,0,0,1,3,0,0,0,4,1,5
662,0,0,0,0,2,0,2,7,0,3,0,1,0,15,2,17
663,0,0,0,0,0,0,0,0,0,0,0,0,0,0,3,3
664,0,0,0,0,0,1,0,0,0,1,0,0,0,2,4,6
665,0,0,0,0,1,1,0,1,1,2,0,0,0,6,2,8
671,0,0,0,0,0,0,0,0,0,2,0,0,0,2,1,3
672,0,0,0,0,0,1,0,5,0,0,0,0,0,6,1,7
674,0,0,0,0,0,0,0,0,0,0,0,0,0,00,03,03
675,0,0,0,0,0,0,0,0,01,0,0,03,0,04,01,05
676,0,0,0,0,0,0,0,0,0,0,0,0,0,00,03,03
681,0,0,0,0,0,0,0,04,0,0,0,0,0,04,01,05
682,0,0,0,0,0,02,0,0,0,0,0,01,0,03,01,04
683,0,0,0,0,0,0,0,0,0,0,0,0,0,00,01,01
684,0,0,0,0,0,0,0,0,01,01,0,0,0,02,01,03
685,0,0,0,0,0,0,0,0,0,03,0,0,0,03,01,04
686,0,0,0,0,0,0,0,0,01,01,0,0,0,02,01,03
687,0,0,0,0,0,0,0,0,0,0,0,0,0,00,00,00
688,0,0,0,0,0,0,0,0,0,02,0,0,0,02,01,03
689,0,0,0,0,01,0,0,0,0,0,0,0,0,01,04,05
691,0,0,0,0,0,0,0,0,0,0,0,0,0,00,00,00
692,0,0,0,0,0,01,0,02,01,02,01,01,0,08,00,08
693,0,0,0,0,0,0,0,0,0,02,0,0,0,02,00,02
694,0,0,0,0,0,0,0,01,0,0,0,0,0,01,01,02
695,0,0,0,0,0,0,01,01,01,08,0,0,0,011,06,017
800,0,0,01,0,0,0,0,01,02,0,0,0,0,04,05,09
801,0,0,0,0,0,0,0,0,0,0,0,0,0,00,00,00
821,0,0,0,0,0,0,0,0,0,0,0,0,0,00,00,00
822,0,0,0,0,0,0,0,0,0,0,0,0,0,00,00,00
823,0,0,0,0,0,0,0,0,0,0,0,0,0,00,02,02
824,0,0,0,0,0,0,0,0,0,0,0,0,0,00,00,00
825,0,0,0,0,0,0,0,0,0,0,0,0,0,00,00,00
962,0,0,0,0,0,0,0,0,0,0,0,0,0,00,00,00
Unk,0,0,01,0,0,0,0,01,0,0,0,01,0,03,02,05
